3rd Party=Terze parti
Access Mode=Modalità d’accesso
Add another Path, Port, Variable, Label or Device=Aggiungi Percorso, Porta, Variabile, Etichetta o Dispositivo
Add Configuration=Aggiungi configurazione
Add=Aggiungi
Additional Requirements=Requisiti aggiuntivi
Addresses=Indirizzi
Always=Sempre
App to Host=App a Host
Application=Applicazione
apply update=applica aggiornamento
Are you sure=Sei sicuro
Array must be Started to view Docker containers=L’Array deve essere **Avviato** per visualizzare i Contenitori Docker
Autostart=Avvio automatico
available=disponibile
Back=Indietro
Backup=Backup
Beta=Beta
Books=Libri
By=Di
Categories=Categorie
Check for Updates=Verifica aggiornamenti
Cloud=Cloud
Compose=Componi
Config Type=Tipo di configurazione
Configuration not found=Configurazione non trovata
Connection Type=Tipo di connessione
Console shell command=Comando shell della Console
Container ID=ID Contenitore
Container IP=IP Contenitore
Container not running=Contenitore spento
Container Path=Percorso Contenitore
Container Port=Porta Contenitore
Container Size=Dimensione Contenitore
Container=Contenitore
CPU Memory load=Utilizzo CPU/RAM
CPU Pinning=CPU Pinning
Created=Creato
Crypto Currency=Criptovalute
Default Value=Valore predefinito
DERP Relay=Relay DERP
Device=Dispositivo
Display=Display
DNS=DNS
Docker Containers=Contenitori Docker
Docker Hub URL=URL Hub Docker
Docker Service failed to start=Avvio Servizio Docker fallito
Downloaders=Downloader
Drivers=Driver
Edit Configuration=Modifica configurazione
Error gathering Tailscale information from container=Si è verificato un errore nell’estrazione delle informazioni Tailscale dal Contenitore.
Exit Node=Nodo di uscita
Exited=Arrestato
Expired RenewDisable key expiry=Chiave scaduta. Rinnova/Disabilita la scadenza della chiave.
Extra Parameters=Parametri aggiuntivi
Fixed IP address=Indirizzo IP statico
force update=Forza aggiornamento
FTP=FTP
Game Servers=Server di gioco
healthy=tutto ok
Hide Buttons=Nascondi pulsanti
Hide docker allocations=Nascondi allocazioni Docker
Hide more settings=Nascondi altre impostazioni
Home Automation=Home Automation
Host Path=Percorso Host
Host Port=Porta Host
Hostname=Nome Host
HT=HT
Icon URL=URL Icona
Image ID=ID Immagine
Is Exit Node=È un nodo di uscita
Key Expiry=Scadenza Chiave
Key=Chiave
Label=Etichetta
LAN IPPort=Indirizzo IP:Porta
Lock sortable items=Abilita personalizzazione elenco
Management=Gestione
MediaApp=MediaApp
MediaServer=MediaServer
Messenger=Messenger
Missing parameters=Parametri mancanti
Music=Musica
Network Type=Tipo di rete
No Docker containers installed=Nessun Contenitore Docker installato
None Listed=Non elencato
of=di
Online=In linea
orphan image=immagine orfana
Other=Altro
Overview=Panoramica
Path=Percorso
Pause All=Tutto in pausa
Photos=Foto
Please check the logs and refresh the page=Controlla i log e aggiorna la pagina
Please check the logs=Controlla i log
Port Mappings=Porte mappate
Port=Porta
Post Arguments=Parametri aggiuntivi
Privileged=Privilegiato
Productivity=Produttività
Project Page=Pagina del Progetto
Proxy=Proxy
Pulling image=Pulling Immagine
Read Me First=Leggimi prima
Read Only - Shared=Solo Lettura - Condiviso
Read Only - Slave=Solo Lettura - Slave
Read Only=Solo Lettura
ReadWrite - Shared=Lettura/Scrittura - Condiviso
ReadWrite - Slave=Lettura/Scrittura - Slave
Real Hostname=Nome Host Reale
rebuild ready=ricostruzione pronta
rebuilding=ricostruzione
Remove template=Rimuovi template
Removing container=Rimuovi Contenitore
Removing orphan image=Rimuovi immagine orfana
Repository=Repository
Required=Richiesta
Reset sorting=Reimposta l’ordinamento
Resume All=Riprendi tutto
Routes=Rotte
Save=Salva
Select a template=Seleziona un template
Select categories=Seleziona categorie
Show docker allocations=Mostra percorsi Docker
Show more settings=Mostra altre impostazioni
Stable=Stabile
Start All=Avvia tutto
starting up containers=Avvio i contenitori
Stop All=Ferma tutto
Stopping container=Fermo i contenitori
Successfully removed container=Contenitore rimosso correttamente
Successfully removed orphan image=Immagine orfana rimossa correttamente
Successfully stopped container=Contenitore fermato correttamente
Support Thread=Discussione di supporto
Tailscale=Tailscale
Template URL=URL Template
Template=Template
The command failed=Comando fallito
The command finished successfully=Comando terminato correttamente
TOTAL DATA PULLED=TOTALE DATI ESTRATTI
Total size=Dimensione totale
Unknown action=Azione sconosciuta
Unlock sortable items=Disabilita personalizzazione elenco
Update All=Aggiorna tutto
update available=aggiornamento disponibile
update ready=aggiornamento pronto
URL=URL
Value=Valore
Variable=Variabile
Video=Video
Voip=VoIP
Volume Mappings=Volumi mappati
wait=Ritardo
Was this container created using this plugin=Questo Contenitore è stato creato usando questo plugin?
Web=Web
WebUI=WebUI
Writable=Scrivibile
Container not found Try reloading this page to fix=Contenitore non trovato. Prova a ricaricare questa pagina per risolvere.
For security reasons, containers with Network Type Host should not have Tailscale enabled Please disable Tailscale in this container or change the Network Type of the container=Per motivi di sicurezza, i Contenitori con 'Tipo di rete' impostato su **Host** non dovrebbero avere Tailscale abilitato. Disabilita Tailscale in questo Contenitore oppure modifica il 'Tipo di rete'.

; Translation completed - 2025-09-04
