also remove image=rimuovi anche l'immagine =
Apply=Applica
Are you sure=Are you sure?
Cancel=Cancella
checking=controllo
Completely REMOVE=RIMUOVI completamente
Console=Console
day=giorno
days=giorni
disk image and definition=immagine disco e definizione
Disks=Dischi
Donate=
Done=Fatto
Edit=Modifica
Execution error=Errore di esecuzione
Force Stop=Forza arresto
Hibernate=Iberna
Log for=Log for:
log=log
Logs=Logs
More Info=Altre Informazioni
No=No
OK=OK
Ok=Ok
Pause=Pausa
Proceed=Procedere
Project Page=Pagina Progetto
Read Me First=
Remove container=Rimuovere contenitore
Remove definition=Rimuovi definizione
Remove image=Rimuovi immagine
Remove VM=Rimuovi VM
Remove=Rimuovi
Restart=Riavvia
Resume=Ripristina
Start=Avvia
Stop=Ferma
Support=Supporto
Update container=Aggiorna contenitore
Update=Aggiorna
Updating all Containers=Aggiornamento di tutti i contenitori
Updating the container=Aggiornamento contenitore
VNC Remote=VNC Remoto
WebUI=WebUI
Yes, delete it=Yes, delete it!
Yes, update it=Yes, update it!
Yes=Si

; footer messages
Array Copying=
Array Clearing=
Array Starting=Avvio Array
Array Stopping=Arresto Array
Mounting disks=Montaggio dischi
Spinning up all drives=Avvia tutti i dischi
Starting services=Avvio  servizi 
Stopping services=Arresto servizi
Unmounting disks=Smonta dischi
Autostart disabled=Autoavvio disattivato
Missing encryption key=Chiave di criptazione mancante
Opening encrypted volumes=Apertura volumi criptati

; docker variables
Container Path=
Container Port=
Container Variable=
Container Label=
Container Device=

; Note: February 27, 2022 - 9 missing translations
