%s An update is available=È disponibile un aggiornamento di %s
Alert Message=Messaggio di avviso
anonymous=anonimo
Author=Autore
cannot check=impossibile verificare
Check For Updates=Verifica aggiornamenti
Checking connectivity=Verifica della connessione
checking=Verifica in corso
Click here to install version %s=Clicca qui per installare la versione %s
Delete Plugin=Elimina Plugin
DOWNGRADE TO VERSION=DOWNGRADE ALLA VERSIONE
Enter URL of remote plugin file or local plugin file=Inserisci il file di installazione del plugin (può essere un URL remoto o il percorso locale dove è memorizzato tale file)
ERROR=ERRORE
I have read the release notes=Ho letto le Note di rilascio
Install Plugin=Installa Plugin
Install=Installa
install=installa
Installed Plugins=Plugin installati
Installing Update=Installo aggiornamento…
need check=è necessario un controllo
Next=Successivo
No plugins installed=Nessun plugin installato
No release notes available=Nessuna nota di rilascio
No response, aborting=Nessuna risposta, interrompo
Plugin File Install Errors=Errori di installazione File del plugin
Plugin File=File Plugin
Plugin History=Cronologia Plugin
Plugin Update Check=Ricerca aggiornamenti Plugin
Plugin=Plugin
Release Notes=Note di rilascio
Remove Plugin=Rimuovi plugin
Remove Selected Plugins=Rimuovi i Plugin selezionati
remove=rimuovi
Select local plugin file=Seleziona il file di installazione del plugin dal percorso locale
Stable=Versione stabile
STALE=SCADUTO
Support Thread=Ottieni assistenza sul Forum Unraid
Uninstall=Disinstalla
Update All Plugins=Aggiorna tutti i Plugin
Update Incompatible=Aggiornamento **NON** compatibile
Update Plugin=Aggiorna Plugin
Upgrade=Aggiorna
View Release Notes=Vedi le Note di rilascio

; Translation completed - 31.10.2025
