%s ago=%s fa
%s is out of range minimum 1 maximum 65535='%s' è fuori intervallo (min 1, max 65535)

; Keep the original plugin name in settings
12 hours=12 ore
24 hours=24 ore
8023ad=802.3ad
a value of zero means no automatic closure=il valore 'zero' disattiva la chiusura automatica
Accumulation duration=Durata accumulo
Accumulation frequency=Frequenza accumulo
Activate=Attiva
Activated=Attivato
Activating=Attivazione…
Active Directory Settings=Impostazioni Active Directory
Active Directory=Active Directory
active-backup=active-backup
AD account login=Login account AD
AD account password=Password account AD
AD domain name=Nome dominio AD
AD initial group=Gruppo iniziale AD
AD initial owner=Proprietario iniziale AD
AD join status=Stato adesione AD
AD short domain name=Nome dominio breve AD
Add network=Aggiungi Rete
Add Peer=Aggiungi Nodo
Add Route=Aggiungi Instradamento
Add Tunnel=Aggiungi Tunnel
Add VLAN=Aggiungi VLAN
Advanced=Avanzate
Agent function=Funzione Agente
Agents=Agenti
Alerts=Avvisi
Allocation profile=Profilo di allocazione
Allow realtime updates on inactive browsers=Consenti aggiornamenti in tempo reale sui browser inattivi
Allow Remote Access=Consenti Accesso Remoto
Allows the use of ethernet frames larger than 1500 bytes=Consente l’uso di frame Ethernet più grandi di 1500 byte
Allow=Consenti
Always On - Manual Port Forward=Sempre Attivo - Port Forwarding Manuale
Always On - UPnP=Sempre Attivo - UPnP
and, the first and last characters must be alphanumeric=e il primo e l’ultimo carattere devono essere alfanumerici
and=e
Any=Qualsiasi
APC UPS Daemon user manual=Manuale utente del Daemon UPS APC
APCsmart=APC Smart
Apply to activate Docker after Array is Started=Applica per attivare Docker dopo l’avvio dell’Array
Apply to activate VMs after Array is Started=Applica per attivare le M.V. dopo l’avvio dell’Array
Applying=Esecuzione in corso…
Array must be Stopped to change=L’Array deve essere **fermato** per apportare le modifiche.
Array status notification=Notifiche Stato Array
Array status=Stato Array
Assignment error=Errore di assegnazione
Attention=Attenzione!
Attribute=Attributo
Authentication method=Autenticazione
auto=auto
Auto-close=Chiusura automatica
automatic=automatico
Autostart=Avvio automatico
Available notifications=Notifiche disponibili
bad or missing key file=file Chiave di Licenza errato o mancante
Balance schedule=Pianificazione Bilanciamento
balance-alb=Bilanciamento del carico adattivo (Active Load Balancing)
Balanced operation=Equilibrato
balance-rr=Bilanciamento sequenziale (Round-Robin)
balance-tlb=Bilanciamento del carico in trasmissione adattivo (Adaptive Transmit Load Balancing)
balance-xor=Bilanciamento con XOR (basato su una funzione XOR)
Bar color - Text=Colore barra - Testo
Bar color=Colore barra
Bar gray - Text=Barra grigia - Testo
Bar gray=Barra grigia
Basic=Semplice
Battery Charge=Carica della batteria
Battery level to initiate shutdown=Livello batteria per avviare lo spegnimento
Best performance=Prestazioni migliori
Best power efficiency=Efficienza energetica migliore
bfq=BFQ
Block group usage=Utilizzo del gruppo di blocchi
Bonding members of=Membri del Bonding per
Bonding mode=Modalità Bonding
boost=boost
Both Web Virt-Manager Remote Viewer=Entrambi
Both=Entrambi
bottom-left=in basso a sinistra
bottom-right=in basso a destra
Boxed=In riquadro
Bridging members of=Membri del bridging di
broadcast=broadcast
Browser=Browser
btrfs filesystem show=Mostra file system BTRFS
btrfs scrub status=Stato scrub BTRFS
btrfs vDisk=vDisk BTRFS
Cache disk not enabled=Disco di Cache disattivato
Cache Settings=Impostazioni Cache
Cannot provision cert that would overwrite your existing custom cert at=Impossibile eseguire il provisioning di un certificato che sovrascriverebbe il tuo certificato personalizzato esistente in
Cannot renew a custom cert at=Impossibile rinnovare un certificato personalizzato in
Cannot renew cert until within 30 days of expiry=Impossibile rinnovare il certificato finché non mancano meno di 30 giorni alla scadenza.
CA-signed certificate file=File del certificato firmato da CA
Caution=Attenzione
Celsius=Celsius (°C)
center=al centro
Certificate expiration=Scadenza del certificato
Certificate issuer=Emittente del certificato
Certificate not valid for=Certificato non valido per
Certificate subject=Soggetto del certificato
Certificate URL=URL del certificato
Certificate will not renew unless you are signed in to Unraidnet=Il certificato non verrà rinnovato a meno che tu non abbia effettuato l’accesso a Unraid.net.
Change encryption key=Modifica la chiave di crittografia
Change power mode=Profilo energetico
Changes=Modifiche
Changing key failed for disks=Modifica chiave fallita per i dischi
Check cable=Controlla il cavo
Check four times a day=Controlla quattro volte al giorno
Check once a day=Controlla una volta al giorno
Check once a month=Controlla una volta al mese
Check once a week=Controlla una volta a settimana
Check twice a day=Controlla due volte al giorno
Checking=Controllo in corso
CIDR optional=CIDR opzionale
Click here to see the Unraid Wiki for more information=Clicca qui per ulteriori informazioni sulla Wiki di Unraid
Click to invoke the Mover=Clicca per avviare il Mover
Click to select PNG file=Clicca per selezionare un file PNG
Click to Select=Clicca per Selezionare
Comma separated list of IPv4 and IPv6 IP addresses=Elenco di indirizzi IPv4 e IPv6 separati da virgola
configure your router with a static route of=configura il tuo router con un instradamento statico di
configure your router with port forwarding of port=configura il tuo router con il port forwarding della porta
configuring interface=configurazione interfaccia
Confirm array stop command=Richiedi conferma per **Fermare l’array**
Confirm reboot powerdown commands=Richiedi conferma per **Riavvio** o **Spegnimento**
Confirm sleep command=Richiedi conferma per **Standby**
Confirmations=Richieste di conferma
Connect Remote Access=Accesso Remoto Unraid Connect
connect to any device on the VPN tunnel=connettiti a qualsiasi dispositivo nel tunnel VPN
connect to this server using IP address=connettiti a questo server usando l’indirizzo IP
Connect to WiFi network=Connetti a una Rete WiFi
Connected to Unraid Connect Cloud=Connesso ad Unraid Connect
Connectivity issues may occur when other devices do not support this feature=Potrebbero verificarsi problemi di connettività se altri dispositivi non supportano questa funzionalità.
Console Options=Tipologia Terminale
Console Settings=Terminale
Container=Contenitore
Content=Contenuto
Copy syslog to flash on shutdown=Copia 'syslog' sull’Unità Flash USB allo spegnimento
Correct file system errors=Correggi errori del File System
CPU Isolation A reboot is required to apply changes=Isolamento CPU: è richiesto il riavvio per applicare le modifiche.
CPU isolation is prohibited while system is running in SAFE MODE=L’isolamento CPU non è consentito mentre il sistema è in Modalità provvisoria.
CPU Isolation=Isolamento Core CPU
CPU Pinning Docker=Allocazione Core CPU - Docker
CPU Pinning VM=Allocazione Core CPU - Macchine Virtuali
CPU Pinning=Gestione CPU
CRAM-MD5=CRAM-MD5
Cumulative parity check=Controllo di Parità cumulativo
Current date and time=Data e ora attuali
Current listening interfaces=Interfacce di ascolto attuali
Current usage ratio=Rapporto di utilizzo attuale
Custom attributes use comma to separate numbers=Attributi personalizzati (usa la virgola per separare i numeri)
Custom banner=Banner personalizzato
Custom UPS cable=Modello Cavo UPS
Custom=Personalizzato
custom=personalizzato
D comma G dot=D virgola : G punto
D comma G none=D virgola : G nessuno
D comma G space=[D] virgola : [G] spazio
D dot G comma=D punto : G virgola
D dot G none=D punto : G nessuno
D dot G space=D punto : G spazio
Daily=Giornaliero
Data received=Dati ricevuti
Data sent=Dati inviati
Date and Time=Data e Ora
Date format=Formato data
Day of the month=Giorno del mese
Day of the week=Giorno della settimana
Day, D Month YYYY=Giorno, G Mese AAAA
Day, DD.MM.YYYY=Giorno, GG.MM.AAAA
Day, DD-MM-YYYY=Giorno, GG-MM-AAAA
Day, MMDDYYYY=Giorno, MM/GG/AAAA
Day, Month D, YYYY=Giorno, Mese G, AAAA
Day, YYYY Month D=Giorno, AAAA Mese G
Day, YYYY-MM-DD=Giorno, AAAA-MM-GG
DD-MM-YYYY=GG-MM-AAAA
Deactivate=Disattiva
Deactivating=Disattivazione in corso…
Default appdata storage location=Percorso archiviazione '/appdata'
Default critical disk temperature threshold=Temperatura critica Disco
Default critical disk utilization threshold=Utilizzo critico Disco
Default critical SSD temperature threshold=Temperatura critica SSD
Default file system for Array disks=File system predefinito dei Dischi dell’Array
Default ISO storage path=Percorso archiviazione Immagini ISO
Default network bridge=Bridge di Rete
Default network source=Interfaccia di Rete
Default partition format=Formato Partizione
Default SMART attribute notifications=Notifica Attributi SMART
Default SMART controller type=Tipo di Controller SMART
Default SMART notification tolerance level=Livello di tolleranza Notifica SMART
Default SMART notification value=Notifica SMART
Default spin down delay=Ritardo Spin Down
Default VM storage path=Percorso archiviazione Macchine Virtuali
Default warning disk temperature threshold=Temperatura Disco
Default warning disk utilization threshold=Utilizzo Disco
Default warning SSD temperature threshold=Temperatura SSD
Default Windows VirtIO driver ISO=Immagine ISO predefinita dei driver VirtIO di Windows
Define a TLS certificate=Definisci un certificato TLS
Delete directory=Elimina Cartella
Delete Image File=Elimina Immagine ISO
Delete Peer=Elimina Peer
Delete tunnel failed=Eliminazione Tunnel fallita
Delete Tunnel=Elimina Tunnel
Delete vDisk file=Elimina file vDisk
Delete VLAN=Elimina VLAN
Deny=Nega
Deselect All=Deseleziona Tutto
Desired MTU=MTU personalizzato
Detailed=Dettagliata
Device=Dispositivo
DHCP pool=Pool DHCP
directory=Cartella
Disable AutostartStart option for VMs=Disabilita 'Avvio automatico' per le M.V.
Disabled until connected to Unraid Connect Cloud=Disabilitato finché non connesso ad Unraid Connect
Disabled until connected to Unraid Connect Cloud - try reloading the page=Disabilitato finché non connesso ad Unraid Connect. Prova a ricaricare la pagina.
Disk Settings=Dischi
Display array totals=Mostra Array totali
Display device name=Mostra Nome dispositivo
Display position=Posizione Banner notifiche
Display Settings=Interfaccia Grafica Utente (GUI)
Display width=Diagonale Display
Display world-wide-name in device ID=Mostra *world-wide-name* nell’ID del dispositivo
DNS Propagation is PENDING=La Propagazione DNS è **PENDENTE**
DNS Rebinding Protection is ENABLED=La Protezione dal Rebinding DNS è **ABILITATA**
DNS servers=Server DNS
docker containers on custom networks need static routing=i Contenitori Docker sulle reti personalizzate necessitano del routing statico
Docker custom network type=Tipologia rete personalizzata Docker
Docker data-root=Tipologia data-root Docker
Docker directory=Percorso archiviazione Cartella Docker
Docker LOG maximum file size=Dimensione massima file Log di Docker
Docker LOG number of files=Numero file Log di Docker
Docker LOG rotation=Rotazione file Log di Docker
Docker only=Solo Docker
Docker PID Limit=Limite PID Docker
Docker service=Servizio Docker
Docker Stop Timeout=Timeout Arresto Docker
Docker storage driver=Driver Archiviazione Docker
Docker update notification=Notifica aggiornamento Contenitori Docker
Docker update=Aggiornamento Contenitore Docker
Docker vDisk location=Posizione vDisk Docker
Docker vDisk size=Dimensione vDisk Docker
Docker version=Versione Docker
Docker VMs=Docker + M.V.
Docker volume info=Informazioni volume Docker
Docker will be available after Array is Started=Il servizio 'Docker' sarà disponibile dopo l’avvio dell’Array.
Docker=Docker
Dont show RDP option=Nascondi opzione RDP
download error=errore download
Download Windows VirtIO driver ISO=Scarica l’immagine ISO dei driver VirtIO di Windows
Downloading=Download in corso
Downstream=Downstream
Drag-n-drop a PNG file or click the image at the left=Trascina un file PNG o clicca sull’immagine a sinistra
Dumb=Semplice
Duplicate metrics=Metriche duplicate
Duplicate port entered=Porta duplicata inserita
Dynamix color theme=Tema Dynamix
eg=per es.
Email recipients=Destinatari e-mail
Email subject prefix=Oggetto e-mail
Email=E-mail
enable advanced settings view=Abilita Vista Avanzata
Enable auto start=Abilita Avvio Automatico
Enable bonding=Abilita Bonding
Enable bridging=Abilita Bridging
Enable container table readmore-js=Abilita Tabella Contenitore readmore-js
Enable default gateway=Abilita Gateway Predefinito
Enable disk shares=Abilita Condivisione Dischi
Enable Docker=Servizio Docker
Enable jumbo frames=Abilita Jumbo Frame
Enable NetBIOS=Abilita NetBIOS
Enable NFS=Abilita NFS
Enable NVME power monitoring=Monitoraggio energia NVME
Enable Outgoing Proxy=Abilita Proxy in uscita
Enable SMB Multi Channel=Abilita SMB Multi-Canale
Enable SMB=Abilita SMB
Enable spinup groups=Abilita Gruppi di spin-up
Enable user shares=Abilita Condivisione
Enable VLANs=Abilita VLAN
Enable VMs=Abilita Macchine Virtuali
Enable WSD=Abilita WSD
encrypted=criptato
Encryption Key Update=Aggiornamento Chiave di Crittografia
Enhanced macOS interoperability=Interoperabilità macOS migliorata
ensure the peer network is different from=assicurati che la rete del peer sia diversa da
ensure the peer networks are different from=assicurati che le reti dei peer siano diverse da
Ensure the primary network card eth0 has an IP address=Assicurati che la scheda di rete primaria 'eth0' abbia un indirizzo IP.
Enter existing passphrase=Digita la frase di accesso esistente
Enter route + gateway + metric=Inserisci Indirizzo IP + Gateway + Metrica
Erase Pool=Cancella Pool
Ether=Ether
Ethernet Port=Porta LAN
Event=Evento
Every 2 hours=Ogni 2 ore
Every 3 hours=Ogni 3 ore
Every 4 hours=Ogni 4 ore
Every 6 hours=Ogni 6 ore
Every 8 hours=Ogni 8 ore
Every day=Ogni giorno
Every hour=Ogni ora
Every month=Ogni mese
Every week=Ogni settimana
exceeds Disk Shutdown=supera lo spegnimento del disco
Exclude listening interfaces=Escludi interfacce di ascolto
Excluded disks=Dischi esclusi
Execution error=Errore di esecuzione
Existing encryption key=Chiave di crittografia esistente
Fahrenheit=Fahrenheit (°F)
Failed to open=Impossibile aprire
Failed to stop=Impossibile fermare
Failure to do so may result in your docker image suffering corruption at a later time=Il mancato rispetto di ciò potrebbe comportare la corruzione della tua immagine Docker in un secondo momento.
Fast=Veloce
Favorites enabled=Mostra Preferiti
File system corruption fixed=Corruzione del file system risolta.
Finished=Finito
First day=Primo giorno
First week=Prima settimana
Flash backup=Backup dell’Unità Flash USB
Font size=Dimensioni Font
Fourth week=Quarta settimana
FTP server=Server FTP
FTP Server=FTP
FTP users=Utenti FTP
Full Balance recommended=Bilanciamento Completo consigliato
gateway name or address=nome o indirizzo gateway
Gateway=Gateway
Generate Key=Genera Chiave
Generate Keypair=Genera Coppia di Chiavi
Global Share Settings=Condivisione
Global SMART Settings=Impostazioni SMART
GraphQL API Developer Sandbox=Sandbox per Sviluppatori API GraphQL
GRUB Configuration=Configurazione GRUB
Hardware=Hardware
Header custom background color=Barra dei menu - Colore Sfondo
Header custom meta text color=Barra dei menu - Colore Testo meta
Header custom secondary text color=Barra dei menu - Colore Testo secondario
Header custom text color=Barra dei menu - Colore Testo
Header menu=Sulla Barra dei menu
Header show description=Mostra Descrizione Server sulla Barra dei menu
HHMM=HH:MM
Hibernate VMs=Iberna Macchine Virtuali
Hidden share names are not allowed=I nomi delle Condivisioni nascoste non sono ammessi.
Hide dot files=Nascondi file 'dot'
Hide=Nascondi
Host access to custom networks=Accesso host a reti personalizzate
Hostname from DNS reverse lookup=Hostname (da lookup DNS inverso)
Hostname from syslog message=Hostname (da messaggio 'syslog')
hosts=host
Hourly=Ogni ora
HTML color code of 3 or 6 hexadecimal digits=Codice colore HTML di 3 o 6 cifre esadecimali
HTTP port=Porta HTTP
httpIPport or httphostport=http://IP:porta oppure http://host:porta
HTTPS port=Porta HTTPS
Huge=Enorme
Identification=Generali
IEEE 8023=IEEE 802.3
if you have trouble logging in, close all other tabs pointing to this server and clear your browsers cache=Se hai problemi ad accedere, chiudi tutte le altre schede che puntano a questo server e svuota la cache del browser.
Import Tunnel=Importa Tunnel
Importance=Importanza
In most cases, this should be your public WAN IPv4 instead=Nella maggior parte dei casi, questo dovrebbe essere invece il tuo Indirizzo IPv4 WAN pubblico.
In most cases, this should be your public WAN IPv4=Nella maggior parte dei casi, questo dovrebbe essere il tuo Indirizzo IPv4 WAN pubblico.
In most cases, this should be your public WAN IPv6 instead=Nella maggior parte dei casi, questo dovrebbe essere invece il tuo Indirizzo IPv6 WAN pubblico.
In most cases, this should be your public WAN IPv6=Nella maggior parte dei casi, questo dovrebbe essere il tuo Indirizzo IPv6 WAN pubblico.
inactive=inattivo
Include listening interfaces=Includi interfacce di ascolto
Included disks=Dischi inclusi
Incorrect existing key=Chiave esistente errata
Input a IPv4 address=Inserisci un indirizzo IPv4
Input a IPv6 address=Inserisci un indirizzo IPv6
Input a MAC address=Inserisci un indirizzo MAC
Input a NTP server name, NTP pool name or IP address=Inserisci il nome di un server NTP, il nome di un pool NTP o un indirizzo IP.
Input the correct date and time manually=Inserisci manualmente la data e l’ora corrette.
Interface description=Descrizione interfaccia
Interface Extra=Interfaccia Extra
Interface link=Link interfaccia
Interface Rules=Regole interfaccia
Interface speed=Velocità interfaccia
Interface=Interfaccia
Invalid data=Dati non validi
Invalid email address=Indirizzo e-mail non valido
Invalid IPv4 gateway=Gateway IPv4 non valido
Invalid IPv4 range=Range IPv4 non valido
Invalid IPv4 subnet=Sottorete IPv4 non valida
Invalid IPv6 gateway=Gateway IPv6 non valido
Invalid IPv6 range=Range IPv6 non valido
Invalid IPv6 subnet=Sottorete IPv6 non valida
Invalid pool address=Pool di indirizzi non valido
Invalid subnet size=Dimensione sottorete non valida
IP address or FQDN=Indirizzo IP o FQDN
IP Address=Indirizzo IP
IPv4 address A.B.C.D=Indirizzo IPv4 (es. 192.168.x.x)
IPv4 address assignment=Assegnazione Indirizzo IPv4
IPv4 address=Indirizzo IPv4
IPv4 custom network on interface=Rete IPv4 personalizzata su interfaccia
IPv4 default gateway=Gateway predefinito IPv4
IPv4 DNS server assignment=Assegnazione server DNS IPv4
IPv4 DNS server=Server DNS IPv4
IPv4 IPv6=IPv4 + IPv6
IPv4 network=Rete IPv4
IPv4 only=Solo IPv4
IPv4nn or IPv6nn route=Instradamento IPv4/nn o IPv6/nn
IPv6 address assignment=Assegnazione Indirizzo IPv6
IPv6 address nnnnxxxxyyyy=Indirizzo IPv6 (es. nnnn:xxxx::yyyy)
IPv6 address=Indirizzo IPv6
IPv6 custom network on interface=Rete IPv6 personalizzata su interfaccia
IPv6 default gateway=Gateway predefinito IPv6
IPv6 DNS server assignment=Assegnazione server DNS IPv6
IPv6 DNS server=Server DNS IPv6
IPv6 network=Rete IPv6
IPv6 only=Solo IPv6
IPv6 privacy extensions=Estensioni di privacy IPv6
ipvlan=IPVLAN
is a self-signed certificate, ignore the browsers warning and proceed to the GUI=è un certificato auto-firmato, ignora l’avviso del browser e procedi per accedere all’Interfaccia Web di Unraid.
is a self-signed certificate, ignore the browsers warning when using this certificate=è un certificato auto-firmato, ignora l’avviso del browser quando usi questo certificato.
is down=è inattivo
is not in the=non è nel
is only available when the filesyestem is mounted=è disponibile solo quando il file system è montato.
Isolated CPUs=CPU isolate
Isolation=Isolamento
Join this network=Unisciti a questa rete
Join=Unisciti
Key successfully changed=Chiave modificata correttamente
Key=Chiave
Keyfile=File della chiave
kyber=Kyber
LAN hub spoke access=Accesso LAN in modalità 'hub-and-spoke'
LAN to LAN access=Accesso LAN in modalità 'LAN to LAN'
Language update notification=Notifica aggiornamento Pacchetto lingua
Language update=Aggiornamento Pacchetto lingua
Language=Lingua
Large=Grande
Last day=Ultimo giorno
Last handshake=Ultimo handshake
Last week=Ultima settimana
LE Cert Provisioned successfully=Certificato LE fornito con successo.
Leave=Esci
Libvirt Log=Log di Libvirt
Libvirt storage location=Percorso archiviazione Libvirt
Libvirt vdisk size=Dimensione vDisk Libvirt
Libvirt version=Versione Libvirt
Libvirt volume info=Info volume Libvirt
License key required=Chiave di Licenza richiesta
List of default gateways contains duplicate metric values=L’elenco dei gateway predefiniti contiene valori di metrica duplicati.
List of peers=Elenco dei peer
List of VLANs contains duplicate VLAN numbers=L’elenco delle VLAN contiene numeri VLAN duplicati.
Listing height=Visualizzazione elenco
Loading=Caricamento in corso…
Local access URLs=URL di accesso locale
Local endpoint=Endpoint locale
Local gateway uses UPnP=Il gateway locale usa UPnP
Local keyboard layout=Layout tastiera locale
Local master=Master locale
Local name=Nome locale
Local private key=Chiave privata locale
Local public key=Chiave pubblica locale
Local screen blank time=Spegni lo schermo locale dopo
Local server configuration=Configurazione del server locale
Local server uses NAT=Il server locale usa NAT
Local syslog folder=Cartella 'syslog' locale
Local syslog maximum file size=Dimensione massima del file 'syslog' locale
Local syslog number of files=Numero di file 'syslog' locali
Local syslog port=Porta 'syslog' locale
Local syslog rotation=Rotazione 'syslog' locale
Local syslog server=Server 'syslog' locale
Local TLD=TLD locale
Local tunnel address IPv6=Indirizzo tunnel locale IPv6
Local tunnel address=Indirizzo tunnel locale
Local tunnel firewall=Firewall tunnel locale
Local tunnel network pool IPv6=Pool di rete tunnel locale IPv6
Local tunnel network pool=Pool di rete tunnel locale
Lost communication=Comunicazione persa
Low on battery=Batteria quasi scarica
MAC address mismatch=Mancata corrispondenza indirizzo MAC
MAC address=Indirizzo MAC
macvlan=MACVLAN
Mail server port=Porta del server e-mail
Mail server=Server e-mail
Make sure you understand what you are doing before enabling=Assicurati di comprendere l’operazione prima di procedere
Manage password=Gestisci password
Manage=Gestisci
Management Access=Accesso e Sicurezza
Management Interface=
mandatory=obbligatorio
Manual input=Input manuale
Manual=Manuale
Max Server Protocol Version=Versione massima del protocollo server
Medium=Medio
member of=membro di
metric value, a lower value is more preferred=valore della metrica, un valore inferiore è preferibile
Metric=Metrica
Mirror syslog to flash=Copia 'syslog' sull’Unità Flash USB
Misconfiguration can cause problems=Una configurazione errata potrebbe causare anomalie
Missing Network Name=Nome di rete assente
Missing new key=Nuova chiave assente
Missing subnet size=Dimensione subnet assente
Missing=Assente
MM-DD-YYYY=MM-GG-AAAA
ModBus=ModBus
Modify with caution unable to validate path until Array is Started=Modifica con cautela: impossibile convalidare il percorso finché l’Array non viene **avviato**.
Month of the year=Mese dell’anno
Monthly=Mensile
Move now=Avvia Mover ora
Mover is running=Mover in esecuzione…
Mover logging=Log del Mover
Mover schedule=Pianificazione del Mover
Mover Settings=Impostazioni Mover
mq-deadline=mq-deadline (Multiqueue Deadline)
MTU size=Dimensioni MTU
Multicast=Multicast
Multi-function=Multifunzione
Must be signed in to Unraidnet to provision cert=Accedi ad Unraid.net per effettuare il provisioning del certificato.
My networks=Le mie reti
name or ip address=nome o indirizzo IP
native=Nativo
Net=Rete
Network Info=Info Rete
Network name=Nome Rete
Network protocol=Protocollo di rete
Network Services=Impostazioni Servizi di Rete
Network Settings=Rete
Never check=Disattivata
Never send=Disattivate
New date and time=Nuova data e ora
NFS=NFS
NFSv3=NFSv3
NFSv4=NFSv4
No Balance required=Bilanciamento non necessario
No battery detected=Nessuna batteria rilevata
No Cache device present=Nessun dispositivo di Cache presente
No Cache disk present=Nessun disco di Cache presente
No change to report=Nessuna modifica da segnalare
No CPU pinning available. Docker service must be started=CPU pinning non disponibile. Il servizio Docker deve essere avviato.
No CPU pinning available. VM service must be started=CPU pinning non disponibile. Il servizio Macchine Virtuali deve essere avviato.
No encrypted disks found=Nessun disco crittografato trovato
no name=nessun nome
No Parity disk present=Nessun Disco di Parità presente
No Reply=Nessuna Risposta
No suitable interfaces found for PTP=Nessuna interfaccia adatta trovata per PTP.
Nominal Power=Potenza nominale
Non-tabbed=Libera
Not activated=Non attivato
Not allowed to assign ZERO cores=Non è possibile assegnare ZERO core
Not compatible with NetBIOS=Non compatibile con NetBIOS
not configured=non configurato
Not present=Non presente
not received=non ricevuto
not set=non impostato
Not up-to-date=Non aggiornato
not used=non in uso
Note=NOTA
Nothing to do=Nessuna azione richiesta
Notices=Generali
Notification Agents=Tipologia notifiche
Notification entity=Categorie notifiche
Notification Settings=Notifiche
Notifications display=Vista notifiche
NTP interval=Intervallo NTP
NTP server=Server NTP
NTP=NTP
Number format=Formato numerico
Number of fuse File Descriptors=Numero di Descrittori di File fuse
Number of Threads=Numero di Thread
Number scaling=Scaling numerico
Obtaining DNSv4 server=Ottengo server DNSv4…
Obtaining DNSv6 server=Ottengo server DNSv6…
Obtaining IPv4 address=Ottengo indirizzo IPv4…
Obtaining IPv4 gateway=Ottengo gateway IPv4…
Obtaining IPv6 address=Ottengo indirizzo IPv6…
Obtaining IPv6 gateway=Ottengo gateway IPv6…
obtaining=ottengo…
On battery=Alimentazione a batteria
One or more paths do not exist=Uno o più percorsi non esistono
Online=Online
Only alphanumeric characters=Solo caratteri alfanumerici
Only modify if this is a new installation since this can lead to unwanted behaviour=Modifica solo se si tratta di una nuova installazione, perché potrebbe causare comportamenti imprevisti.
Only PNG images are allowed=Sono ammesse solo immagini PNG
Oops=Si è verificato un errore
optional metric lowest is preferred, 0 is no default gateway=metrica opzionale (un valore più basso è preferibile; 0 significa nessun gateway predefinito)
optional metric lowest is preferred=metrica opzionale (un valore più basso è preferibile)
Optional=Opzionale
Or if they are improperly configured, use this feature with care=O se sono configurati in modo errato, usa questa funzione con cautela.
or=o
Other networks=Altre reti
Otherwise use the keyfile method for UTF8 input=In caso contrario, usa il metodo del **file chiave** per l’input UTF8.
Outgoing Proxy Manager=Gestore Proxy in uscita
Outgoing Proxy=Proxy in uscita
Output Voltage=Voltaggio in uscita
overlay2=Overlay2
Override UPS Capacity Watts=Capacità UPS (in watt)
Page view=Visualizzazione pagina
Parity Check=Controllo di Parità
Passphrase=Frase di Accesso
Password=Password
Path does not exist=Il percorso non esiste
PCIe ACS override=Override ACS PCIe
PCnet=PCnet
Peer allowed IPs=IP consentiti del Peer
Peer DNS server=Server DNS del Peer
Peer endpoint=Endpoint del Peer
Peer name=Nome del Peer
Peer preshared key=Chiave precondivisa del Peer
Peer private key=Chiave privata del Peer
Peer public key=Chiave pubblica del Peer
Peer tunnel address IPv6=Indirizzo tunnel del Peer IPv6
Peer tunnel address=Indirizzo tunnel del Peer
Peer type of access=Tipo di accesso del Peer
Peer update required=Aggiornamento del Peer richiesto
Perform TRIM Operation=Esegui operazione TRIM
Permit exclusive shares=Consenti Condivisioni esclusive
Persistent Bash History=Cronologia persistente
Persistent keepalive=Keepalive persistente
Ping=Ping
Placement of Users menu=Posizione Menu Utenti
Please consider re-applying all configurations=Considera di riapplicare tutte le configurazioni.
Please disable the VM function=Disabilita il Servizio M.V.
Please do this NOW=Procedi **ORA**
Please enter a valid gateway=Inserisci un gateway valido.
Please enter a valid range=Inserisci un intervallo valido.
Please enter a valid sending email address=Inserisci un indirizzo e-mail di invio valido.
Please enter a valid subnet=Inserisci una sottorete valida.
Please match the requested format=Formato non conforme a quello richiesto.
Please note that the flash backup is not encrypted at this time=NOTA: Il backup dell’Unità Flash USB non è crittografato.
Please read the Help carefully=Leggi attentamente le Note di aiuto
Please Reboot system to make new rules active=Riavvia il sistema per rendere effettive le nuove regole.
Please Stop array to complete key installation=Arresta l’Array per completare l’installazione della chiave.
Plugins update notification=Notifica aggiornamento Plugin
Plugins update=Aggiornamento Plugin
Pool address is out of range=L’indirizzo del pool è fuori intervallo.
pool device stats=Statistiche Dispositivo pool
Pool Device Status=Stato Dispositivo pool
Pool Information=Informazioni pool
Pool subnet size is not defined=La dimensione della sottorete del pool non è stata definita.
Pool subnet size is too large=La dimensione della sottorete del pool è troppo grande.
Port %s is already in use by other services=La porta '%s' è già in uso da altri servizi.
Port %s is duplicated=La porta '%s' è duplicata.
Port %s is out of range minimum 1 maximum 65535=La porta '%s' è fuori intervallo (min 1, max 65535).
Port already in use=Porta già in uso.
Port Down=Porta disattivata.
Port out of range=Porta fuori intervallo.
Port Up=Porta attiva.
Power Mode=Modalità Operativa
Preserve user defined networks=Preserva le reti definite dall’utente
Preset service=Servizio preimpostato
Printable Characters Only=Solo Caratteri Stampabili
Priority in header=Priorità nell’intestazione
Protocol=Protocollo
Provision=Provisioning
PTP clock=Clock PTP
PTP interface=Interfaccia PTP
PTP mode=Modalità PTP
PTP profile=Profilo PTP
PTP server=Server PTP
PTP transport=Trasporto PTP
PTP=PTP
QEMU version=Versione QEMU
Questions See the documentation=Domande? Consulta <a href="https://wiki.unraid.net/Connect" target="_blank">la documentazione</a>.
raidz1=RAID-Z1
readmodifywrite=Tradizionale (read/modify/write)
Receive bitrate=Bitrate in ricezione
recommended=consigliato
reconstruct write=Turbo (reconstruct write)
redirects to=reindirizza a
Refreshing=Aggiornamento…
Registration key required=Chiave di Registrazione richiesta
Regulatory region=Area geografica
Reinitialize=Re-inizializza
Reinitializing=Re-inizializzazione in corso…
Remark configure your router with port forwarding of port=NOTA: Configura il 'Port Forwarding' sul tuo router.
Remark to use the Dynamic - Manual Port Forward option for Remote Access please set Use SSLTLS to Strict in Management Access=NOTA: Per usare l’opzione 'Dinamico - Inoltro della Porta Manuale' per l’Accesso Remoto, imposta 'Usa SSL/TLS' su **Restrittivo** in 'Impostazioni → Accesso e Sicurezza'.
Remark to use the UPnP options please set Use UPnP to Yes in Management Access=NOTA: per usare le opzioni UPnP, imposta 'Abilita UPnP' su **Sì** in 'Impostazioni → Accesso e Sicurezza'.
Remark=NOTA
Remote access to LAN=Accesso remoto alla rete LAN
Remote access to server=Accesso remoto al server
Remote peer configuration=Configurazione del peer remoto
Remote syslog port=Porta 'syslog' remota
Remote syslog server=Server 'syslog' remoto
Remote tunneled access=Accesso tramite tunnel remoto
Remove pool=Rimuovi pool
Remove Pool=Rimuovi Pool
Remove Windows VirtIO driver ISO=Rimuovi l’immagine ISO dei driver VirtIO di Windows
Replied=Risposto
Required=Richiesto
resolution=Risoluzione
Restore default image=Ripristina immagine predefinita
Retype new passphrase=Digita nuovamente la frase di accesso
Route=Instradamento
Routing Table=Tabella di Instradamento
Rule=Regola
Rules contain duplicate MAC address assignments=Le regole contengono assegnazioni di indirizzi MAC duplicate.
Rules=Regole
Runtime left to initiate shutdown=Tempo rimanente prima dello spegnimento
Runtime Left=Tempo rimanente
Samba extra configuration=Configurazione avanzata SMB
Scheduled parity check=Pianificazione Controllo di Parità
Scheduler=Operazioni pianificate
Scrub schedule=Pianificazione dello scrub
Scrub Schedule=Pianificazione dello Scrub
Scrub=Scrub (operazione)
Second week=Seconda settimana
See Help for more details and workarounds=Consulta la **Guida** per maggiori dettagli e soluzioni alternative.
see interface=vedi interfaccia
Select All=Seleziona Tutto
Select existing keyfile=Seleziona il file della chiave di crittografia esistente
Select new keyfile=Seleziona il nuovo file della chiave di crittografia
Select Proxy=Seleziona Proxy
Self-signed certificate file=File del certificato auto-firmato
Self-signed or user-provided certificate=Certificato auto-firmato o fornito dall’utente
Send crash information to Unraid developers=Invia informazioni sui crash agli sviluppatori Unraid
Send every hour=Invia ogni ora
Send every two hours=Invia ogni due ore
Send four times a day=Invia quattro volte al giorno
Send once a day=Invia una volta al giorno
Send once a month=Invia una volta al mese
Send once a week=Invia una volta a settimana
Send three times a day=Invia tre volte al giorno
Send twice a day=Invia due volte al giorno
Sending email address=Indirizzo e-mail di invio
Server hub spoke access=Accesso hub e spoke del server
Server name=Nome del server
Server to server access=Accesso server a server
Server was unable to provision SSL certificate=Il server non è stato in grado di effettuare il provisioning del certificato SSL.
Set password=Imposta password
Setting disabled in safe mode=Impostazione disabilitata in **Modalità provvisoria**
Settings menu=All’interno di Impostazioni
Show array utilization indicator=Mostra Indicatore utilizzo array
Show banner background color fade=Mostra Sfumatura colore di sfondo del banner
Show banner=Mostra Banner
Show Dashboard apps=Mostra App della dashboard
show passphrase=mostra frase di accesso
Show Peer Config=Mostra Configurazione Peer
Show RDP menu option=Menu RDP
Show RDP option=Mostra Opzione RDP
Show VM Usage=Mostra Utilizzo Macchine Virtuali
Show=Mostra
Shutdown time-out=Timeout di spegnimento
Shutdown VMs=Spegni Macchine Virtuali
shutdown=spegni
Sign In to Unraidnet required=Accesso a Unraid.net richiesto
Signal level=Livello segnale
Simple=Semplice
slave=slave (secondario)
Slow=Lento
Small=Piccolo
Smart=SMART
SMB Extras=Parametri SMB extra
SMB Settings=Impostazioni SMB
SMB=SMB
SMTP Settings=Impostazioni SMTP
SNMP=SNMP
Software=Software
Sorry, an error occurred in processing your SSL certificate=Si è verificato un errore durante l’elaborazione del tuo certificato SSL.
Sorry, an error occurred updating unraidnet DNS records=Si è verificato un errore durante l’aggiornamento dei record DNS di Unraid.net.
SSH port=Porta SSH
Start APC UPS daemon=Abilita Gestione UPS
Start page=Pagina di apertura
Static=Statico
Stop %s to make changes, see=Ferma **%s** per apportare le modifiche. Apri
Stop corresponding docker containers=Arresta i Contenitori Docker corrispondenti
Store notifications to flash=Salva notifiche sull’Unità Flash USB
stripe=stripe
Subject=Soggetto
Subnet=Sottorete
subnet=sottorete
success=successo
Summarized=Riassunto
Switching the Storage Driver requires to delete and rebuild the Docker directory manually=Modificando il 'Driver di Archiviazione' dovrai eliminare e ricreare la cartella di Docker.
Syslog Server=Server syslog
System goes down=Il sistema è in fase di spegnimento…
System identifier for logfile name=Identificatore del sistema per il nome del file di log
System notifications=Notifiche di sistema
System Setting=Impostazione di Sistema
System Settings=Impostazioni di Sistema
Tabbed=A schede
Tailscale Lets Encrypt certificate=Certificato Let’s Encrypt di Tailscale
Tailscale URLs=URL Tailscale
TCP=TCP
TELNET port=Porta TELNET
Temperature unit=Unità temperatura
Template Authoring Mode=Modalità di Creazione Template
Terminal font size=Dimensioni Font Terminale
Test running=Test in corso…
Test=Test
Text - Bar color=Testo - Barra (colore)
Text - Bar gray=Testo - Barra (grigio)
Text=Testo
The Local endpoint does not resolve to an IPv4 address=L’Endpoint locale non si risolve in un indirizzo IPv4.
The Local endpoint does not resolve to an IPv6 address=L’Endpoint locale non si risolve in un indirizzo IPv6.
The Local endpoint resolves to=L’Endpoint locale si risolve in
The Local tunnel network pool cannot be in=Il pool di rete del tunnel locale non può essere in
The Local tunnel network pool IPv6 cannot be in=Il pool di rete del tunnel locale IPv6 non può essere in
Third week=Terza settimana
This is required to create VMs in KVM=Questa operazione è necessaria per creare Macchine Virtuali in KVM.
this mode requires a network switch with proper setup and support=questa modalità richiede uno switch di rete con configurazione e supporto adeguati.
this must be the only peer in the tunnel and sole active tunnel when in use=questo deve essere l’unico peer nel tunnel e l’unico tunnel attivo quando in uso.
This removes any connections running over this tunnel=Questa operazione rimuove tutte le connessioni in esecuzione su questo tunnel.
This Unraid Server was unreachable from the outside=Questo server Unraid non era raggiungibile dall’esterno.
This will unassign all devices from the pool but will NOT modify any device contents=Questa operazione rimuoverà l’assegnazione tutti i dispositivi dal pool, ma **NON** modificherà il contenuto di alcun dispositivo.
Time format=Formato Orario
Time of the day=Ora del giorno
Time on battery before shutdown=Tempo di funzionamento a batteria prima dello spegnimento
Time state=Stato Orario
Time sync=Sincronizzazione Orario
Time zone=Fuso Orario
time-out=timeout
Timestamp=Timestamp
TLS certificate location=Posizione del certificato TLS
To test your manual port forward, temporarily configure Allow Remote Access as Always On - Manual Port Forward=Per testare il Port Forwarding manuale, imposta temporaneamente ’Consenti Accesso Remoto’ su ’Sempre Attivo - Port Forwarding Manuale’
to=a
Toggle keys=Attiva/Disattiva Chiavi
Toggle thread to containers=Attiva/Disattiva Assegnazione thread ai Contenitori Docker
Toggle view=Attiva/Disattiva Vista
top-left=in alto a sinistra
top-right=in alto a destra
Transmit bitrate=Bitrate in trasmissione
Trim Now=Esegui TRIM ora
TRIM operation started=TRIM avviato
TRIM schedule=Pianificazione TRIM
TRIM Settings=Impostazioni TRIM
trim=TRIM
Tunable enable Direct IO=Parametro 'Direct I/O'
Tunable enable NCQ=Parametro 'NCQ'
Tunable fuse_remember=Parametro 'fuse_remember'
Tunable md_num_stripes=Parametro 'md_num_stripes'
Tunable md_queue_limit=Parametro 'md_queue_limit'
Tunable md_sync_limit=Parametro 'md_sync_limit'
Tunable md_write_method=Parametro 'md_write_method'
Tunable nr_requests=Parametro 'nr_requests'
Tunable poll_attributes=Parametro 'poll_attributes'
Tunable scheduler=Parametro 'scheduler'
Tunable support Hard Links=Parametro 'support Hard Links'
Tunnel has running containers attached=Al tunnel sono collegati Contenitori Docker in esecuzione.
tunnel is inactive=il tunnel è inattivo.
Tunnel wg0=Tunnel wg0
Turn off UPS after shutdown=Spegni UPS dopo l’arresto del sistema
Two letter country code=Codice Nazione di due lettere.
Type new passphrase=Digita nuova frase di accesso
UDP=UDP
UDPv4=UDPv4
UDPv6=UDPv6
Unable to register this Unraid Server=Impossibile registrare questo server Unraid
Unassigned Devices=Dispositivi Non assegnati
unavailable=non disponibile
Unicast=Unicast
Unlimited=Illimitato
Unraid Connect=Unraid Connect
Unraid Lets Encrypt certificate=Certificato Let’s Encrypt di Unraid
Unraid OS update notification=Notifica aggiornamento Unraid OS
Unraid OS update=Aggiornamento Unraid OS
Unraidnet account status=Stato Account Unraid.net
Unraidnet Status=Stato Unraid.net
Update DNS=Aggiorna DNS
updating=aggiornamento in corso
Updating=Aggiornamento in corso
Upgrade Cert=Aggiorna Certificato
Upgrade ZFS Pool=Aggiorna Pool ZFS
UPnP forwarding not set=UPnP: inoltro non impostato
UPnP state changed to=Stato UPnP cambiato in
UPnP tunnel is inactive=UPnP: il tunnel è inattivo
Upon host shutdown=Azione all’arresto di Unraid
UPS cable=Cavo UPS
UPS Details=Dettagli UPS
UPS Load=Carico UPS
UPS Model=Modello UPS
UPS overloaded=Sovraccarico UPS
UPS Settings=Gruppo di continuità
UPS Status=Stato UPS
UPS type=Tipologia UPS
URL=URL
USB=USB
Use ASCII characters from space to tilde=Usa caratteri **ASCII** dallo Spazio ' ' alla Tilde '~'.
Use DEFAULT setting when public NTP servers are defined=Imposta su 'Predefinito' quando sono in uso server NTP pubblici.
Use image name dockerimg or docker-xfsimg or select a folder=Usa il nome immagine 'docker.img' o 'docker-xfs.img', oppure seleziona una cartella.
Use NTP=Imposta automaticamente
Use only letters A-Z, digits or space,dash,underscore=Usa solo lettere A-Z, cifre o spazio, trattino, underscore
use printable characters only=usa solo caratteri stampabili
Use SSH=Abilita SSH
Use SSLTLS=Abilita SSL/TLS
Use STARTTLS=Abilita STARTTLS
Use TELNET=Abilita TELNET
Use UPnP=Abilita UPnP
Used Free columns=Colonne Occupato / Libero
User Preferences=Preferenze Utente
User root=Utente 'root'
User shares not enabled=Condivisioni utente non abilitate
User Utilities=Impostazioni Plugin
User=Utente
Username=Nome utente
user-set=definito dall’utente
uses=usi
value must be a number=il valore deve essere un numero
Value=Valore
vcpu allocated to vm=vCPU allocata alla M.V.
Very large=Molto grande
Very small=Molto piccolo
VFIO allow unsafe interrupts=Consenti interruzioni non sicure VFIO
View libvirt log=Visualizza Log di Libvirt
View Local Config=Visualizza Configurazione Locale
View Peer Config=Visualizza Configurazione Peer
View the Docs for more information=Visualizza la Documentazione per maggiori informazioni
view=visualizza
Virt-Manager Remote Viewer=Visualizzatore Remoto di Virt-Manager
VLAN assignment mismatch=Mancata corrispondenza nell’assegnazione VLAN
VLAN number=Numero VLAN
VM Manager=Gestione Macchine Virtuali
VM manager=Gestione Macchine virtuali
VM Settings A reboot is required to apply changes=Impostazioni Macchina Virtuale: È richiesto il riavvio per applicare le modifiche.
VM shutdown time-out=Timeout Spegnimento Macchine Virtuali
VM Usage refresh timerseconds=Aggiornamento statistiche Macchine Virtuali
VM=Macchina virtuale
VMs only=Solo Macchine Virtuali
VMs will be available after Array is Started=Il servizio 'Macchine Virtuali' sarà disponibile dopo l’avvio dell’Array.
VPN Manager=VPN
VPN tunnel access for System=Accesso tunnel VPN per il Sistema
VPN tunnel for docker containers only=Tunnel VPN solo per i Contenitori Docker
VPN tunneled access for docker=Accesso tunnel VPN per Docker
VPN tunneled access for system=Accesso tunnel VPN per il Sistema
VPN tunneled access=Accesso tunnel VPN
WAN Port=Porta WAN
Warnings=Avvertimenti
Watts=watt
Web interface=Interfaccia Web
Week of the month=Settimana del mese
Weekly=Settimanale
When running Unraid virtualized, there are no available power modes=Quando Unraid è virtualizzato non sono disponibili opzioni di risparmio energetico.
Wi-Fi=Wi-Fi
WireGuard Configuration=Configurazione WireGuard
WireGuard URLs=URL WireGuard
Wireless=Wireless
Workgroup Settings=Impostazioni Workgroup
Workgroup=Workgroup
Write corrections to parity disk=Scrivi le correzioni sul Disco di Parità
Wrong PTP server address=Indirizzo server PTP errato
WSD options experimental=Opzioni WSD [sperimentale]
xfs vDisk=vDisk XFS
Yearly=Annuale
You can not exclude this interface=Non puoi escludere questa interfaccia.
You must be signed in to Unraidnet in order to generate an Unraidnet SSL certificate=Devi aver effettuato l'accesso ad Unraid.net per generare un certificato SSL Unraid.net.
Your existing Docker image file needs to be recreated due to an issue from an earlier beta of Unraid 6=Il file immagine Docker esistente deve essere ricreato a causa di un problema riscontrato in una beta precedente di Unraid 6.
Your hardware does not have Intel VT-x or AMD-V capability=Il tuo hardware non dispone delle funzionalità Intel VT-x o AMD-V.
Your Lets Encrypt SSL Certificate has been provisioned and a DNS record for local IP address=Il tuo certificato SSL Let’s Encrypt è stato sottoposto a provisioning ed è stato creato un record DNS per l’indirizzo IP locale.
Your Lets Encrypt SSL Certificate has been renewed=Il tuo certificato SSL Let’s Encrypt è stato rinnovato.
Your local IP address %s has been updated for unraidnet=Il tuo indirizzo IP locale %s è stato aggiornato per Unraid.net.
Your router or DNS server has DNS rebinding protection enabled, preventing=Il tuo router o server DNS ha la protezione dal rebinding DNS abilitata, impedendo
Your server has been registered=Il tuo server è stato registrato!
Your Unraid Server is reachable from the internet=Il tuo server Unraid è raggiungibile da Internet.
YYYY-MM-DD=AAAA-MM-GG
zfs pool information=Informazioni sul Pool ZFS
zfs=ZFS

; My Servers plugin
Account status=Stato Account
Also delete cloud backup Restore from backup will be unavailable=Inoltre, elimina il backup nel cloud. Il ripristino da backup non sarà disponibile.
Always - Manual Port Forward=Sempre - Port Forwarding Manuale
Always - UPnP=Sempre - UPnP
Are you sure you want pause communication with your remote flash backup on unraidnet=Sicuro di voler mettere in pausa la comunicazione con il tuo backup remoto dell’Unità Flash USB su Unraid.net?
Are you sure you want to delete your cloud backup Restore from backup will be unavailable=Sicuro di voler eliminare il tuo backup nel cloud? Il ripristino da backup non sarà disponibile.
Are you sure you want to delete your local flash backup=Sicuro di voler eliminare il tuo backup locale dell’Unità Flash USB?
Are you sure you want to erase all change history in both local and unraidnet remote=Sicuro di voler cancellare tutta la cronologia delle modifiche sia in locale che in remoto su Unraid.net?
Connected to My Servers Cloud=Connesso a My Servers Cloud
Delete Cloud Backup=Elimina Backup nel Cloud
Disabled until connected to My Servers Cloud=Disabilitato finché non connesso a My Servers Cloud.
Disabled until you have signed in=Disabilitato finché non avrai effettuato l’accesso.
Disabled until you Provision a myunraidnet SSL Cert=Disabilitato finché non avrai effettuato il Provisioning di un Certificato SSL my.unraid.net.
Disabled until you Provision an unraidnet SSL Cert and set SSL-TLS to Auto=Disabilitato finché non avrai effettuato il Provisioning di un Certificato SSL Unraid.net e impostato SSL-TLS su Auto.
Disabled until you Provision an unraidnet SSL Cert=Disabilitato finché non avrai effettuato il Provisioning di un Certificato SSL Unraid.net.
Disabled until your root user account is password-protected=Disabilitato finché il tuo account utente root non sarà protetto da password.
Dynamic - Manual Port Forward=Dinamico - Port Forwarding Manuale
Dynamic - UPnP=Dinamico - UPnP
Dynamic Remote Access allows you to do stuff that someone else can explain=L’Accesso Remoto Dinamico ti permette di fare cose che qualcun altro può spiegare.
Enable Transparent 2FA for Local Access=Abilita l’Autenticazione in 2 Fattori per l’Accesso Locale
Enable Transparent 2FA for Remote Access=Abilita l’Autenticazione in 2 Fattori per l’Accesso Remoto
In order to activate Flash Backup there must be at least 1GB of free space on your flash drive=Per attivare il Backup dell’Unità Flash USB deve esserci almeno 1 GB di spazio libero su tale unità.
Local T2FA requires a myunraidnet certificate=L’Autenticazione in 2 Fattori locale richiede un certificato *.my.unraid.net.
Local T2FA requires Unraid 610 or higher and a myunraidnet certificate=L’Autenticazione in 2 Fattori locale richiede Unraid 6.10 o superiore e un certificato *.my.unraid.net.
Local T2FA requires Unraid 610 or higher=L’Autenticazione in 2 Fattori locale richiede Unraid 6.10 o superiore.
Local T2FA requires Use SSLTLS to be Auto and a myunraidnet certificate=L’Autenticazione in 2 Fattori locale richiede che l’uso di SSL/TLS sia su Auto e un certificato *.my.unraid.net.
Local T2FA requires Use SSLTLS to be Auto and Unraid 610 or higher=L’Autenticazione in 2 Fattori locale richiede che l’uso di SSL/TLS sia su Auto e Unraid 6.10 o superiore.
Local T2FA requires Use SSLTLS to be Auto, Unraid 610 or higher, and a myunraidnet certificate=L’Autenticazione in 2 Fattori locale richiede che l’uso di SSL/TLS sia su Auto, Unraid 6.10 o superiore e un certificato *.my.unraid.net.
Local T2FA requires Use SSLTLS to be Auto=L’Autenticazione in 2 Fattori locale richiede che l’uso di SSL/TLS sia su Auto.
More information=Ulteriori informazioni
port=porta
Remote T2FA requires a myunraidnet certificate=L’Autenticazione in 2 Fattori remota richiede un certificato *.my.unraid.net.
Remote T2FA requires Remote Access to be enabled and a myunraidnet certificate=L’Autenticazione in 2 Fattori remota richiede che l’Accesso Remoto sia abilitato e un certificato *.my.unraid.net.
Remote T2FA requires Remote Access to be enabled and Unraid 610 or higher=L’Autenticazione in 2 Fattori remota richiede che l’Accesso Remoto sia abilitato e Unraid 6.10 o superiore.
Remote T2FA requires Remote Access to be enabled, Unraid 610 or higher, and a myunraidnet certificate=L’Autenticazione in 2 Fattori remota richiede che l’Accesso Remoto sia abilitato, Unraid 6.10 o superiore e un certificato *.my.unraid.net.
Remote T2FA requires Remote Access to be enabled=L’Autenticazione in 2 Fattori remota richiede che l’Accesso Remoto sia abilitato.
Remote T2FA requires Unraid 610 or higher and a myunraidnet certificate=L’Autenticazione in 2 Fattori remota richiede Unraid 6.10 o superiore e un certificato *.my.unraid.net.
Remote T2FA requires Unraid 610 or higher=L’Autenticazione in 2 Fattori remota richiede Unraid 6.10 o superiore.
The Unraid server is unreachable from outside your network Be sure you have configured your router to forward port=Il server Unraid è irraggiungibile dall’esterno della tua rete. Assicurati di aver configurato il Port Forwarding sul tuo router.
to the Unraid server at=al server Unraid in
Transient errors in this log can be ignored unless you are having issues=Gli errori transitori in questo log possono essere ignorati, a meno che tu non stia riscontrando problemi.
Unraid API extra origins=Origini extra dell’API Unraid
View Flash Backup Error Log=Visualizza Log Errori Backup Unità Flash USB

; Translation completed - 24.10.2025
