20 EHCI=2.0 (EHCI)
30 nec XHCI=3.0 (NEC XHCI)
30 qemu XHCI=3.0 (QEMU XHCI)
9p Mode=Modalità 9p
Advanced tuning options=Opzioni di ottimizzazione avanzate
Allocation=Allocazione
and if using graphics device passthrough it too needs UEFI=e se usi il passthrough di schede grafiche hai bisogno dell’UEFI
Are you sure=Confermi?
Array must be started to view Virtual Machines=L’Array deve essere avviato per visualizzare le Macchine Virtuali (M.V.)
Autostart=Avvio automatico
Back=Indietro
Base Image=Immagine di base
Block Devices=Dispositivi a blocchi
Boot Order=Ordine di Avvio
Boot order=Ordine di avvio
Bus=BUS
Capacity=Capacità
CD1 ISO Image=Immagine ISO CD1
CD2 ISO Image=Immagine ISO CD2
Change Icon=Modifica icona
Check free space=Controlla spazio libero
Cleanup=Pulisci
Click and Select cdrom image to install operating system=Clicca e Seleziona l’immagine CD-ROM per installare il sistema operativo
Clock Offset=Sfasamento del Clock
Clocks Offset=Sfasamento dei Clock
Clocks=Clock
Clone=Clona
Config Folder=Cartella di Configurazione
Configure the same IP address on the ipvtap interface=Configura lo stesso indirizzo IP sull’interfaccia IPVTAP.
Configure the VM with a static IP address=Configura la Macchina Virtuale con un indirizzo IP statico.
Copy Paste Domain XML Configuration Here=Incolla qui la configurazione XML del dominio
CPU Mode=Modalità CPU
CPUs=CPU
Create=Crea
CreateModify Template=Crea/Modifica Template
Creating=Creazione in corso…
DateTime=Data e Ora
define if migratable=definisci se migrabile
define Multifunctiion Support=definisci il Supporto Multifunzione
define OS boot options=definisci le opzioni di avvio del sistema operativo
define the amount memory=definisci la quantità di memoria
define the maximum amount of memory=definisci la quantità massima di memoria
define type of cpu presented to this vm=definisci il tipo di CPU assegnato a questa Macchina Virtuale
description of virtual machine=descrizione macchina virtuale
Description=Descrizione
Deselect All=Deseleziona tutto
Discard=Annulla modifiche
Disk capacity has to be greater than %s=La capacità del disco deve essere superiore a %s
Disk devices=Dischi
Disk devicesVolume=Dischi/Volumi
Disk IO=I/O Disco
Displays and RAM=Display e RAM
Download Folder=Cartella di Download
Download, Click and Select virtio drivers image=Scarica, Clicca e Seleziona i driver VirtIO
Downloading=Download in corso…
Driver=Driver
Edit VM after clone=Modifica Macchina Virtuale dopo la clonazione
eg=per es.
Eject CD Drive=Espelli CD-ROM
Emulated=Emulato
Enable USB boot=Abilita avvio da USB
Enter name=Inserisci nome
Error occured=Si è verificato un errore.
ETA=ETA
Evdev Device=Dispositivo Evdev
Export User Template=Esporta Template Utente
Extracting=Estrazione in corso…
File exists=Il file esiste già.
File for import=File da importare
File write failed=Scrittura del file non riuscita.
Files being removed=Rimozione dei file in corso…
Folder to save the LibreELEC image to=Cartella in cui salvare l’immagine di LibreELEC
Folder to save the OpenELEC image to=Cartella in cui salvare l’immagine di OpenELEC
Form View=Visualizza Form
free=liberi
FS Native Snapshot=Snapshot nativo FS
GPU is primary adapter, vbios may be required=La GPU è l’adattatore primario, potrebbe essere necessario il vBIOS.
grab options=opzioni di acquisizione
Grab Toggle=Attiva/Disattiva Acquisizione
Grab=Acquisisci
Graphics Card=Scheda Grafica
Graphics ROM BIOS=ROM BIOS Scheda Grafica
Graphics ROM Needed=ROM Grafica necessaria
Graphics=Grafica
Guest agent not installed=Guest Agent non installato
Guest CPU=CPU Guest
Guest not running or guest agent not installed=Guest non in esecuzione o Guest Agent non installato.
Guest not running=Guest non in esecuzione.
Hide inline xml=Nascondi XML inline.
Host CPU=CPU Host
Host Passthrough=Host Passthrough
Hyperv tweaks for Windows=Ottimizzazione Hyper-V per Windows
Hyper-V=Hyper-V
i440fx will work for most='i440fx' funzionerà quasi sempre
Icon=Icona
If name already exists it will be replaced=Se il nome esiste già, verrà sostituito.
Import from file=Importa da file
Import=Importa
Initial=Iniziale
Insert CD=Inserisci CD-ROM
Insert=Inserisci
Interfaces=Interfacce
Invalid storage path=Percorso di archiviazione non valido.
Invalid VM to edit=Impossibile modificare la M.V. selezionata.
IP Address=Indirizzo IP
ISO Image=Immagine ISO
ISO storage path doesnt exist, please create the user share or empty folder first=Il percorso delle immagini ISO non esiste. Crea una Condivisione o una cartella vuota per iniziare.
ISO storage path doesnt exist=Il percorso delle immagini ISO non esiste.
ISO storage path was empty=Il percorso delle immagini ISO era vuoto.
keyboard for VM Console=tastiera della Console della M.V.
keyboard for VNC=tastiera VNC
Leaving blank will use OS name=Se lasciato vuoto, verrà utilizzato il nome del sistema operativo.
LibreELEC Version=Versione LibreELEC
LibreELEC=LibreELEC
Libvirt Service failed to start=L’avvio del servizio 'Libvirt' è fallito.
Location of virtual machine files=Posizione dei file della macchina virtuale
Lock sortable items=Disabilita personalizzazione elenco
Logical CPUs=CPU logiche
Machine=Macchina
Manual configuration required=È richiesta la configurazione manuale.
Manual Configuration Required=Configurazione Manuale Richiesta.
Manual=Manuale
Max=Max
MD5 verification failed, your download is incomplete or corrupted=Verifica MD5 fallita: il download è incompleto o corrotto.
Memory dump=Dump della memoria
Memory inuseCurrentMaximum=RAM In uso/Allocata/Massima
Migratable=Migrabile
Mode=Modalità
mount tag inside vm=tag di mount all’interno della M.V.
Multifunction=Multifunzione
My Workstation=La mia Workstation
Name contains invalid characters or does not start with an alphanumberic for a ZFS storage location=Il nome contiene caratteri non validi o non inizia con un carattere alfanumerico per una posizione di archiviazione ZFS.
Name contains invalid characters or does not start with an alphanumberic for a ZFS storage locationOnly these special characters are valid Underscore _ Hyphen - Colon Period=Il nome contiene caratteri non validi o non inizia con un carattere alfanumerico per una posizione di archiviazione ZFS. Solo questi caratteri speciali sono validi: '_' (underscore), '-' (trattino), ':' (due punti), '.' (punto).
name of mount tag inside vm=nome del tag di mount all’interno della M.V.
Name of virtual machine=Nome della Macchina Virtuale
Network Bridge=Rete Bridge
Network IO=I/O Rete
Network MAC=MAC Rete
Network Model=Modello Rete
Network Source=Sorgente Rete
New VM=Nuova Macchina Virtuale
No CD image inserted in to drive=Nessuna immagine CD inserita nell’unità.
No CD image inserted into drive=Nessuna immagine CD inserita nell’unità.
No GPU=Nessuna GPU
No IP, guest agent not installed=Nessun indirizzo IP, Guest Agent non installato.
No pinning set=Nessun pinning impostato
No Virtual Machines installed=Nessuna Macchina Virtuale installata
nogpu=nogpu
None available=Nessuno disponibile
Not enough free space, need at least %s MB=Spazio libero insufficiente, sono necessari almeno %s MB.
Not running=Non in esecuzione
Not set=Non impostato
Only one VM can be active at the time=Può essere eseguita una sola Macchina Virtuale alla volta.
Only these special characters are valid Underscore _ Hyphen - Colon Period=Solo questi caratteri speciali sono validi: '_' (underscore), '-' (trattino), ':' (due punti), '.' (punto).
OpenELEC Version=Versione di OpenELEC
OpenELEC=OpenELEC
Optional=Opzionale
OS Install CDRom Bus=BUS CD-ROM del sistema operativo
OS Install ISO=Immagine ISO del sistema operativo
Other PCI Devices=Altre periferiche PCI
Other XML=Altro XML
Override Storage Location=Forza Posizione di Archiviazione
Overwrite=Sovrascrivi
OVMF requires a UEFI-compatable OS=OVMF richiede un sistema operativo compatibile con UEFI
OVMF TPM=OVMF TPM
OVMF=OVMF
Parent=Immagine di base
password for VM Console=password per la Console della M.V.
password for VNC=password per VNC
path of Unraid share=percorso della Condivisione Unraid
path on Unraid share to save LibreELEC settings=percorso della Condivisione Unraid in cui salvare le impostazioni di LibreELEC
path on Unraid share to save OpenELEC settings=percorso della Condivisione Unraid in cui salvare le impostazioni di OpenELEC
Path to ROM BIOS file=Percorso del file ROM BIOS
Pinned Cores=Core riservati
Pivot=Pivot
Please choose a folder the LibreELEC image will download to=Scegli una cartella in cui scaricare l’immagine di LibreELEC
Please choose a folder the OpenELEC image will download to=Scegli una cartella in cui scaricare l’immagine di OpenELEC
Pop-up Blocker is enabled Please add this site to your exception list=Blocco pop-up attivo. Aggiungi questo sito alla lista esclusioni.
port for virtual console=porta per la Console virtuale
Prefix=Prefisso
Present=Presente
Primary=Primario
protocol for virtual console=protocollo per la Console virtuale
Q35 for a newer machine model with PCIE=Q35 per un modello di macchina più recente con PCIe
QEMU Command Line=Riga di comando QEMU
QEMU64=QEMU64
random mac, you can supply your own=indirizzo MAC casuale, puoi fornirne uno tuo.
re-generate random mac address=crea nuovo indirizzo MAC casuale
Remove all files=Rimuovi tutti i file
Remove Images=Rimuovi Immagini
Remove LibreELEC image=Rimuovi l’immagine di LibreELEC
Remove Meta=Rimuovi Metadati
Remove OpenELEC image=Rimuovi l’immagine di OpenELEC
Remove this LibreELEC file=Rimuovi questo file di LibreELEC
Remove this OpenELEC file=Rimuovi questo file di OpenELEC
Remove User Template=Rimuovi Template Utente
Rename disabled, %s snapshots exists=Rinomina disabilitato, esistono %s istantanee.
Render GPU=Renderizza GPU
RenderGPU=Renderizza GPU
Repeat=Ripeti
Requires guest agent installed=Richiede che il Guest Agent sia installato
Requires guest running=Richiede che il Guest Agent sia in esecuzione
Save File Name=Nome file da salvare
Save Path=Percorso di salvataggio
SeaBIOS will work for most=SeaBIOS funzionerà quasi sempre
SeaBIOS=SeaBIOS
Select All=Seleziona tutto
Select File=Seleziona File
Select ISO image=Seleziona immagine ISO
Select ISO=Seleziona immagine ISO
Select ISOs for CDROMs=Seleziona immagini ISO per le unità CD-ROM
Select the BIOS=Seleziona il BIOS
Select the LibreELEC version to use=Seleziona la versione di LibreELEC da utilizzare
Select the machine model=Seleziona il modello della macchina
Select the OpenELEC version to use=Seleziona la versione di OpenELEC da utilizzare
Select the USB Controller to emulate=Seleziona il Controller USB da emulare
Select=Seleziona
Separate sub-folder and image will be created based on Name=Verranno creati una sottocartella e un’immagine separati in base al nome.
Serial=Seriale
Set discard option=Imposta opzione discard
Set SDD flag=Imposta flag SDD
Set SSD flag=Imposta flag SSD
shares=Condivisioni
Show Inline XML=Mostra XML inline
Snapshot Method=Metodo Istantanea
Snapshot Name=Nome Istantanea
Snapshot=Istantanea
Snapshots being removed=Rimozione delle Istantanee in corso…
Snapshots=Istantanee
Some OSes wont support USB3=Alcuni sistemi operativi non supportano USB 3.
Sound Card=Scheda Audio
Specify a ISO storage path first=Prima specifica un percorso di archiviazione per le immagini ISO.
SSD=SSD
Start All=Avvia tutte
Start Cloned VM=Avvia M.V. clonata
Start VM after creation=Avvia la Macchina Virtuale dopo la creazione
Stop All=Ferma tutte
Template exists=Il Template esiste già.
Template file write failed=Scrittura del file Template fallita.
Template Name=Nome Template
Tickpolicy=Politica del timer
Timer Source=Sorgente del timer
Toggle VM autostart=Attiva/Disattiva avvio automatico M.V.
Top Image=Immagine superiore
Type Method=Tipo (Metodo)
type of storage image=tipo di immagine di archiviazione
Unchecked will use QEMU External Snapshot=Se non selezionato, verrà utilizzata l’istantanea esterna di QEMU.
Unknown action=Azione sconosciuta
Unknown version=Versione sconosciuta
Unlock sortable items=Abilita personalizzazione elenco
Unraid Mount tag=tag per il mount di Unraid
Unraid Mount Tag=Tag per il mount di Unraid
Unraid Share Mode=Modalità Condivisione Unraid
Unraid Share=Condivisione di Unraid
Unraid Source Path=Percorso sorgente Unraid
Updating=Aggiornamento in corso…
USB Controller=Controller USB
USB Devices=Dispositivi USB
vCPUs=vCPU
vDisk Bus=BUS vDisk
vDisk Location=Posizione vDisk
vDisk Size=Dimensione vDisk
vDisk Type=Tipo vDisk
vDisks vCDs=vDisk/vCD
vDisks=vDisk
Verifying=Verifica
video for VM Console=video per la Console della M.V.
video for VNC=video per VNC
VirtIO Drivers CDRom Bus=BUS del CD-ROM dei driver VirtIO
VirtIO Drivers ISO=Immagine ISO dei driver VirtIO
Virtiofs Mode=Modalità Virtiofs
Virtual Machines=Macchine Virtuali
Virtual=Virtuale
virtual=virtuale
VM Being Cloned=Clonazione M.V. in corso…
VM Being removed=Rimozione M.V. in corso…
VM Clone=Clona Macchina virtuale
VM Console AutoPort=Porta automatica della Console M.V.
VM Console enable Copypaste=Abilita Copia/Incolla nella Console della M.V.
VM Console Keyboard=Tastiera della Console della M.V.
VM Console Password=Password della Console della M.V.
VM Console Port=Porta della Console della M.V.
VM Console Protocol=Protocollo della Console della M.V.
VM Console Video Driver=Driver Video della Console della M.V.
VM Console WS Port=Porta WS della Console della M.V.
VM creation error=Errore durante la creazione della Macchina Virtuale
VM image deletion error=Errore durante l’eliminazione dell’immagine della Macchina Virtuale
VM Name=Nome Macchina Virtuale
VM Usage Statistics=Statistiche uso Macchina Virtuale
VNC Keyboard=Tastiera per VNC
VNC Password=Password per VNC
VNC Video Driver=Driver Video per VNC
VNC=VNC
Warning removing Snapshots can break the chain=Attenzione: la rimozione delle istantanee può compromettere la catena.
Wasnt able to stop the process=Non è stato possibile arrestare il processo.
Web UI to start from menu=Interfaccia Web da avviare dal menu
Web UI to start=Interfaccia Web da avviare
WebUI=Interfaccia Web
Windows 7XP=Windows 7/XP
Windows 82012, newer Linux distros=Windows 8/2012, versioni Linux recenti
wsport for virtual console=Porta WS per la Console virtuale
XML View=Visualizza XML

; Translation completed - 06.09.2025
