Automatic theming=Tema automatico
Bing API key=Chiave API Bing
Bing=Bing
City name=Nome della città
Country name=Nome del paese
Day theme=Tema Chiaro
Geocoding service=Servizio di geocodifica
Google API key=Chiave API Google
Google=Google
MapQuest API key=Chiave API MapQuest
MapQuest=MapQuest
Night theme=Tema Scuro
No geographical coordinates found for the given address=Non sono state trovate coordinate geografiche per l’indirizzo fornito
Please adjust=Si prega di modificare
Postal code=Codice postale
See=Visita
Street address=Indirizzo
this site=questo sito
to obtain a Bing API key=per ottenere una chiave API Bing
to obtain a Google API key=per ottenere una chiave API Google
to obtain a MapQuest API key=per ottenere una chiave API MapQuest

:day_night_plug:
> Inserisci le informazioni del tuo indirizzo (via, città, paese) che vengono utilizzate per calcolare gli orari di alba e tramonto della tua posizione.
>
> Un servizio di geocoding viene utilizzato per convertire il tuo indirizzo in coordinate geografiche (latitudine e longitudine).<br>
> È necessario registrarsi presso uno dei servizi disponibili e ottenere una chiave API univoca per poter utilizzare il rispettivo servizio.
>
> Il **Tema Chiaro** viene utilizzato dall’alba al tramonto.<br>
> Il **Tema Scuro** viene utilizzato dal tramonto all’alba.
:end
