Cancel=Annulla

; My PSAs / banners
Happy New Year=Buon Anno Nuovo
Happy Holidays from Andrew, Tracey, and family=Buone Vacanze da Andrew, Tracey e famiglia
Please Enjoy Responsibly=Si prega di usare con responsabilità
Popup Blocked CA requires popups to be enabled under certain circumstances You must white list your server within your browser to allow popups=Popup bloccato. Community Applications richiede che i popup siano abilitati in determinate circostanze. Devi inserire il tuo server nella lista bianca del browser per consentire i popup.
Docker Service Not Enabled - Only Plugins Available To Be Installed Or Managed=Servizio Docker non abilitato - È possibile installare o gestire solo i plugin.
Docker system failed to start - Only Plugins Available To Be Installed Or Managed=Il sistema Docker non è riuscito ad avviarsi - È possibile installare o gestire solo i plugin.
Array not started - Only Plugins Available To Be Installed Or Managed=Array non avviato - È possibile installare o gestire solo i plugin.
Community Applications works best when cookies are enabled in your browser Certain features may not be available=Community Applications funziona al meglio quando i cookie sono abilitati nel tuo browser. Alcune funzionalità potrebbero non essere disponibili.
Backup Server Active Some icons may not appear, and plugin installations may be affected=Server di backup attivo. Alcune icone potrebbero non apparire e le installazioni dei plugin potrebbero essere influenzate.
Debugging enabled This significantly increases the memory used by your browser=Debugging abilitato. Questo aumenta significativamente la memoria utilizzata dal tuo browser.
Browser translation detected Display issues may result=Traduzione del browser rilevata. Potrebbero verificarsi problemi di visualizzazione.
Action Centre Enabled=Nuove notifiche nel **Centro Azione**
Deprecated OS version No further updates to Community Applications will be issued for this OS version=Versione del sistema operativo obsoleta. Non verranno rilasciati ulteriori aggiornamenti per Community Applications su questa versione del sistema operativo.

; Sorting Options
Sort By=Ordina per
Name Ascending=Nome (A-Z)
Name Descending=Nome (Z-A)
Downloads=Download
Date Added=Data di aggiunta
Number Of Apps=Numero di app
; Initial disclaimer translations
Disclaimer=Dichiarazione di non responsabilità
All applications listed here are 3rd party additions to Unraid Neither the authors of Community Applications nor Limetech make any warranty as to the suitability of any application listed here=Tutte le applicazioni qui elencate sono aggiunte di terze parti a Unraid. Né gli autori di Community Applications né Limetech forniscono alcuna garanzia sul funzionamento di qualsiasi applicazione qui elencata.
Every attempt is made to ensure that only safe and compatible applications are present=Ogni tentativo è fatto per assicurare che siano presenti solo applicazioni sicure e compatibili.
Application Policy=Politica delle Applicazioni
I Understand=Capisco
Installations of apps disabled You must accept the warning to be able to install applications=L’installazione delle app è disabilitata. Devi accettare l’avviso per poter installare le applicazioni.
Click here=Clicca qui
%s Results Per Page=%s Risultati per pagina
Results Per Page: %s=Risultati per pagina: %s

; Plugin Disclaimer
Plugin Note=Community Applications contiene sia Contenitori Docker che Applicazioni (plugin). I Plugin sono progettati per migliorare l’esperienza di Unraid, vengono eseguiti con privilegi completi sul tuo sistema e sono chiaramente identificati all’interno di Community Applications.

; Multi Install
Install Plugin Applications=Installa Applicazioni (plugin)
Select all on page=Seleziona tutto nella pagina
Install Application=Installa App
Install Applications=Installa App
Update Application=Aggiorna App
Update Applications=Aggiorna App
Are you sure you want to update %s applications=Confermi di voler aggiornare %s applicazioni?
Are you sure you want to install %s docker and %s plugin applications=Confermi di voler installare %s Contenitori Docker e %s Applicazioni (plugin)?

; Searches
Search=Cerca
Click Here To Get More Results From DockerHub=Clicca qui per ottenere più risultati da DockerHub
No Matching Applications Found=Nessuna app corrispondente trovata

; Repository Related
%s removed as favourite repository=%s rimosso dai repository preferiti
%s set as favourite repository=%s impostato come repository preferito
Click to remove favourite repository=Clicca per rimuovere dai repository preferiti
Click to set %s as favourite repository=Clicca per impostare %s come repository preferito
Search for apps in repository=Cerca app nel repository
No description present=Nessuna descrizione presente
Go to the forum page=Vai alla pagina del forum
Go to the webpage=Vai alla pagina web
Go to reddit=Vai su Reddit
Go to facebook=Vai su Facebook
Go to discord=Vai su Discord
Go to forum profile=Vai al profilo del forum
Show Profile=Mostra Profilo
SHOW MORE=MOSTRA DI PIÙ
SHOW LESS=MOSTRA DI MENO
Read more=Scopri di più
Total Applications=App totali
Total Known Downloads=Download totali
Total Docker Applications=Contenitori Docker totali
Total Plugin Applications=Plugin totali
Total Languages=Pacchetti Lingua totali
Average Downloads Per App=Media dei download per App
Web Page=Pagina Web
Forum=Forum
Forum Profile=Profilo del Forum
Profile=Profilo
Facebook=Facebook
Reddit=Reddit
Twitter=X
Discord=Discord
Search Apps=Cerca App
Registry=Registro
Details=Dettagli
Added=Aggiunto
; Install Plugin title of openbox
Install Plugin=Installa Plugin
Update Plugin=Aggiorna Plugin

Requirements not met=Requisiti non rispettati
The requirements for this upgrade have not been met on your system=I requisiti per questo aggiornamento non sono stati soddisfatti sul tuo sistema.
The sidebar for the app click info will list the details=La barra laterale, attivata dal click sull’app, mostrerà i dettagli.

BACK=INDIETRO

; Remove App from previously installed
Delete Template=Elimina Template
Yes, delete it=Conferma

; Uninstall popup
Uninstall Application=Disinstalla App
Yes uninstall it=Conferma

; Remove Private Application
Remove Private Application=Rimuovi Applicazione Privata
Yes, remove it=Conferma

; App Pinning
Click to pin this application=Clicca per fissare questa applicazione
Click to unpin this application=Clicca per sbloccare questa applicazione
Pin App=Fissa App
Unpin App=Sblocca App

; Branch installations
Choose A Branch To Install=Scegli la Linea di sviluppo da utilizzare per l’installazione

; Multiple application installs
; no apps selected
Install Selected Applications=Installa le app selezionate

Yes, install it=Conferma

; Multi-install popup
Yes, install them=Conferma
Cookies not enabled Plugins must be separately installed from docker applications=Cookie non abilitati. Le App (plugin) devono essere installate separatamente dai Contenitori Docker.
Docker applications will be installed utilizing the most recently saved template with no user input on your part=I Contenitori Docker verranno installati utilizzando il template più recente, senza alcun input da parte tua.
Updating Support Links=Aggiornamento dei link di supporto
Downloading docker icons=Download delle icone Docker
Finished Installing If the DONE button did not appear, then you will need to click the red X in the top right corner=Installazione completata. Se il pulsante "FATTO" non è apparso, clicca sulla X rossa nell’angolo in alto a destra.

; error messages
An error occurred Could not find any %s Apps=Si è verificato un errore. Impossibile trovare l’app %s.
Download of appfeed failed=Download del feed di applicazioni fallito.
; the %s here refers to a function being called
Something really went wrong here=Si è verificato un errore
Post the ENTIRE contents of this message in the Community Applications Support Thread=Pubblica l’INTERO contenuto di questo messaggio nel thread di supporto di Community Applications.
Unknown error happened Please post a screenshot in the support thread of the Statistics screen=Si è verificato un errore sconosciuto. Per favore, posta uno screenshot della schermata Statistiche nel thread di supporto.
This plugin has a duplicated name from another plugin %s This will impact your ability to install both plugins simultaneously=Questo plugin ha un nome duplicato rispetto a un altro plugin: %s. Questo influirà sulla tua capacità di installare entrambi i plugin contemporaneamente.
You have been logged out=Sei stato disconnesso
Fatal Flash Drive Error=Errore fatale dell’unità Flash USB
This usually means your flash drive is corrupted or has dropped offline The rest of the Unraid GUI will also be affected Post a new thread in the Unraid forums if this error continues=Questo di solito significa che la tua unità Flash USB è corrotta o si è disconnessa. Anche il resto dell’interfaccia grafica di Unraid sarà influenzato. Apri una nuova discussione nei forum di Unraid se questo errore persiste.
Fatal Docker Image Error=Errore Fatale dell’Immagine Docker
Your docker image or folder is either read-only or completely full Issues will result because of this You should create a new post in the Unraid forums and include your diagnostics=La tua immagine o cartella Docker è di sola lettura o completamente piena. Potresti riscontrare alcuni problemi a causa di ciò. Dovresti creare un nuovo post sul forum di Unraid e includere i tuoi dati diagnostici.
This template is set up to use a custom network You may have to adjust the network or IP address etc to match your system=Questo template è configurato per usare una rete personalizzata. Potresti dover modificare le impostazioni di rete (come ad es. l’indirizzo IP) per adattarle al tuo sistema.
This template is set up to run as Privileged This is a possible security risk and usually does not need to be enabled Note that some applications require privileged in order to operate correctly=Questo template è impostato per essere eseguito come "Privilegiato". Questo è un possibile rischio per la sicurezza e di solito non è necessario abilitarlo. Nota che alcune applicazioni richiedono questa impostazione per funzionare correttamente.
One or more ports used by this application are already in use by another service or app running on your server You will need to adjust the host ports accordingly on the template=Una o più porte utilizzate da questa applicazione sono già in uso da un altro servizio o app in esecuzione sul tuo server. Dovrai modificare le porte host sul template.
Not Enough Memory=Memoria Insufficiente
Community Applications and Unraid OS have a minimum required installed memory of 4G CA cannot run without those mimimums being met=Community Applications e Unraid OS hanno un requisito minimo di memoria RAM installata di 4 GB. Community Applications non può funzionare senza che questi requisiti minimi siano soddisfatti.
Run Anyways=Esegui comunque
Memory Requirements not met Problems may result=Requisiti di memoria non soddisfatti. Potrebbero verificarsi problemi.
Installation already in progress=Installazione già in corso
Another plugin installation or update is already in progress and this one cannot start Wait until the current installation or update is completed and try again=Un’altra installazione o aggiornamento di plugin è già in corso. Attendi che l’installazione o l’aggiornamento corrente sia completato e riprova.
Clear Flag=Cancella Flag
%s is incompatible with your OS version Please update the OS to proceed=%s è incompatibile con la tua versione del sistema operativo. Aggiorna il sistema operativo per procedere.
%s is incompatible with your OS version Either uninstall %s or update the OS=%s è incompatibile con la tua versione del sistema operativo. Disinstalla %s oppure aggiorna il sistema operativo.
Browser failed to communicate with Unraid Server=Il browser non è riuscito a comunicare con il server Unraid.
For unknown reasons, your browser was unable to communicate with Community Applications running on your server=Per ragioni sconosciute, il tuo browser non è riuscito a comunicare con Community Applications in esecuzione sul tuo server.
Additional information may be within Tools, PHPSettings - View Log=Ulteriori informazioni potrebbero trovarsi in 'Strumenti → Impostazioni PHP → Visualizza Log'.
Attempt to Fix Via Reload Page=Prova a risolvere aggiornando la Pagina
External Link=Link esterno
Clicking OK will take you to a 3rd party website not associated with Limetech=Cliccando '**OK**' verrai reindirizzato a un sito web di terze parti non associato a Limetech.

; CA Sections Keep the length reasonable
Home=Home
Installed Apps=App installate
Previous Apps=App precedenti
Pinned Apps=App fissate
Favourite Repo=App preferite
Action Centre=Centro Azione
Recently Added=Aggiunte di recente
Random Apps=App casuali
Top New Installs=App più installate
Top Trending Apps=App di tendenza
Spotlight Apps=App in evidenza
All Apps=Tutte le app
Statistics=Statistiche
Credits=Ringraziamenti
Support=Supporto
VERSION=VERSIONE
Change Log=Note di rilascio
Debugging=Debugging

; Credits
Development=Team di sviluppo
Additional Contributions=Contributi aggiuntivi
GUI Layout Design=Designer UI
Application Feed=Feed delle applicazioni
Additional Testing=Test aggiuntivi
Moderation=Moderatori
Additional Libraries=Librerie aggiuntive
Copyright=Copyright
Translation=Traduzione

; Statistics page

unknown=sconosciuto
Last Change To Application Feed=Ultima modifica al Feed delle Applicazioni
Docker Applications=Contenitori Docker
Plugin Applications=Applicazioni (plugin)
Templates=Template
Official Containers=Contenitori Ufficiali
Repositories=Repository
Private Docker Applications=Contenitori Docker privati
Invalid Templates=Template non validi
Template Errors=Errori Template
Blacklisted Apps=App nella Blacklist
Incompatible Applications=App incompatibili
Deprecated Applications=App obsolete
Moderation Entries=Registro moderazioni
Primary Server=Server Primario
Backup Server=Server Secondario
Installs not allowed from this page=Installazioni non consentite da questa pagina

; Statistics Popup
No invalid templates found=Non è stato trovato alcun template non valido
These templates are invalid and the application they are referring to is unknown=Questi template non sono validi e l’applicazione a cui si riferiscono è sconosciuta.
No templates were automatically fixed=Nessun template è stato corretto automaticamente.
All of these errors found have been fixed automatically=Tutti gli errori trovati sono stati corretti automaticamente.
Note that many of these errors can be avoided by following the directions=Si noti che molti di questi errori possono essere evitati seguendo le istruzioni.
HERE=QUI
The following plugins have duplicated filenames and are not able to be installed simultaneously=I seguenti plugin hanno nomi di file duplicati e non possono essere installati contemporaneamente.
The following docker applications refer to the same docker repository but may have subtle changes in the template to warrant this=I seguenti Contenitori Docker si riferiscono allo stesso repository Docker ma potrebbero avere alcune differenze nel template che lo giustificano.
If any of these entries are incorrect then contact the moderators of CA to discuss=Se una di queste voci non è corretta, contatta i moderatori di Community Applications per discuterne.
Global Repository Comments=Commenti Globali del Repository
Applied to all applications=(Applicato a tutte le app)
Individual Application Moderation=Moderazione delle Singole App

; Misc
Community Applications Changelog=Changelog di Community Applications

Each month we highlight some of the amazing work from our community=Ogni mese mettiamo in evidenza alcuni degli incredibili lavori della nostra community
Check out these newly added applications from our awesome community=Dai un’occhiata a queste applicazioni appena aggiunte dalla nostra fantastica community
Check out these up and coming apps=Scopri queste app emergenti
These apps have the highest percentage of new installs=Queste app hanno la più alta percentuale di nuove installazioni
An assortment of randomly chosen apps=Un assortimento di app scelte casualmente
Featured Applications=Applicazioni in Evidenza

; Categories try not to be excessively long This is displayed on the left of CA screen

Backup=Backup
Cloud=Cloud
Crypto Currency=Cryptovalute
Downloaders=Gestori di Download
Drivers=Driver
Game Servers=Server di Gioco
Home Automation=Domotica
Media Applications=App Multimediali
Books=Libri
Music=Musica
Photos=Foto
Video=Video
Other=Altro
Media Servers=Server Multimediali
Network Services=Servizi di Rete
DNS=DNS
FTP=FTP
Management=Gestione
Messenger=Messaggistica
Proxy=Proxy
VOIP=VoIP
VPN=VPN
Web=Web
Privacy=Privacy
Productivity=Produttività
Security=Sicurezza
Spotlight=In Evidenza
Tools Utilities=Strumenti/Utility
System=Sistema
Themes=Temi
Utilities=Utility
Private Apps=App Private
Uncategorized=Nessuna Categoria

; Categories displayed within a popup or on the card.  Where an entry exists after the "=" it is not translated, but rather how it should look
GameServers=Server di Gioco
HomeAutomation=Domotica
MediaApp=App Multimediali
MediaAppBooks=App Multimediali: Libri
MediaAppMusic=App Multimediali: Musica
MediaAppPhotos=App Multimediali: Fotografia
MediaAppVideo=App Multimediali: Video
MediaAppOther=App Multimediali: Altro
MediaServer=Server Multimediali
MediaServerBooks=Server Multimediali: Libri
MediaServerMusic=Server Multimediali: Musica
MediaServerPhotos=Server Multimediali: Fotografia
MediaServerVideo=Server Multimediali: Video
MediaServerOther=Server Multimediali: Altro
Network=Servizi di Rete
NetworkDNS=Servizi di Rete: DNS
NetworkFTP=Servizi di Rete: FTP
NetworkManagement=Servizi di Rete: Gestione
NetworkProxy=Servizi di Rete: Proxy
NetworkVOIP=Servizi di Rete: VoIP
NetworkVPN=Servizi di Rete: VPN
NetworkPrivacy=Servizi di Rete: Privacy
NetworkWeb=Servizi di Rete: Web
NetworkOther=Servizi di Rete: Altro
ToolsSystem=Strumenti/Utility: Sistema
ToolsThemes=Strumenti/Utility: Temi
ToolsUtilities=Strumenti/Utility: Utility
OtherUncategorized=Altro: Nessuna Categoria
and %s more=e ulteriori %s

; App Popup Related
This application template has been blacklisted=Il template di quest’applicazione è stato inserito nella blacklist
This application template has been deprecated=Il template di quest’applicazione è obsoleto
This application has additional requirements=Quest’app presenta requisiti aggiuntivi
Additional Requirements=Requisiti Aggiuntivi
Donate To Author=Dona all’Autore
Donate To Maintainer=Dona al Maintainer
CLOSE=CHIUDI
Author=Autore
Maintainer=Maintainer
DockerHub=DockerHub
Application Template=Template dell’Applicazione
DockerHub Stars=Valutazione DockerHub
Added to CA=Aggiunto a Community Applications
Date Updated=Data Aggiornamento
Current Version=Ultima Vers.
Min OS=Vers. OS min.
Max OS=Vers. OS max.
Total Downloads=Download Totali
Popularity=Popolarità
Licence=Licenza
Ranked #%s=Classificato #%s
; as in Trending up or down arrow
Trending %s=Tendenza %s
; as in As of some date
As of %s=(A partire dal %s)
Play Video=Riproduci Video
Play Video %s=Riproduci Video %s
This application is not compatible with your version of Unraid=Quest’applicazione non è compatibile con la tua versione di Unraid
Another browser tab or device has updated the displayed templates Some actions are not available=Un’altra scheda del browser o un altro dispositivo ha aggiornato i template visualizzati. Alcune azioni non sono disponibili.
WebUI=Interfaccia Web
Reinstall=Reinstalla
Reinstall From Previous Apps=Reinstalla da App Precedenti
Install=Installa
Uninstall=Disinstalla
Project=Progetto
Read Me First=Leggimi
Install another instance=Installa un’altra istanza
Install Using The Templates Default Tag=Installa Usando il Tag Predefinito del Template
Moderator Comments=Commenti del Moderatore:
Note not all authors keep up to date on change logs=Nota: non tutti gli autori aggiornano i changelog.
Note not all maintainers keep up to date on change logs=Nota: non tutti i maintainer aggiornano i changelog.
Last Update=Ultimo Aggiornamento
Note All statistics are only gathered every 30 days=Nota: Tutte le statistiche vengono raccolte solo ogni 30 giorni.
;the following if using a space you MUST use nbsp but keep it down to one word if at all possible
Donate=Fai una donazione
Currently Installed Version=Versione Attualmente Installata
Install The Update=Installa l’Aggiornamento
; as in you have the latest version already installed
Latest Version=Ultima Versione
Multi Language Support=Supporto Multi-lingua
Support Forum=Ottieni Aiuto
; as in more than 100000
More than %s=Più di %s
Remove from Previous Apps=Rimuovi da App Precedenti
Remove=Rimuovi
See All Apps=Vedi tutte le App
Favourite=Preferito
Application Type=Tipo di App

; Graphs
Trend Per Month=Tendenza Mensile
Downloads Per Month=Download Mensili

; Multi install script
Installing docker applications %s=Installazione dei Contenitori Docker %s…
Starting %s=Avvio di %s
%s failed to start You should install it by itself to fix the errors=%s non è riuscito ad avviarsi. Dovresti installarlo singolarmente per risolvere gli errori.
Setting installed applications to autostart=Impostazione dell’avvio automatico delle applicazioni installate
Docker Application Installation finished=Installazione del Contenitore Docker completata

; Application Cards
Actions=Azioni
Pending=In sospeso
This application is a driver plugin=Quest’app è un driver (plugin)
This is a language pack=Questo è un pacchetto lingue
This application is a docker container=Quest’app è un Contenitore Docker
This application is a plugin=Quest’app è un plugin
This is a spotlight application=Questa è un’app in evidenza
This is your favourite repository=Questo è il tuo repository preferito
This application is from your favourite repository=Quest’app proviene dal tuo repository preferito
This application is pinned for later viewing=Quest’app è fissata per la visualizzazione successiva
Private Application=App privata
Remove Application From List=Rimuovi app dall’elenco
Check off to select multiple reinstalls=Seleziona per scegliere reinstallazioni multiple
Go to the plugin settings=Vai alle impostazioni del plugin
Click to reinstall the application using default values=Clicca per reinstallare l’app usando i valori predefiniti
Click to edit the application values=Clicca per modificare i valori dell’app
Click to reinstall=Clicca per reinstallare
Click to install=Clicca per installare
Click to go to the WebUI=Clicca per andare all’interfaccia Web
This application template has been deprecated=Il template di questa applicazione è obsoleto
This application template has been blacklisted=Il template di questa applicazione è stato inserito nella blacklist
Click info to see the notes regarding this application=Clicca su "Info" per vedere le note riguardanti quest’app
This application has additional requirements=Quest’app presenta requisiti aggiuntivi
BETA=BETA
INSTALLED=INSTALLATO
OFFICIAL=UFFICIALE
UPDATED=AGGIORNATO
This is an official container=Questo è un Contenitore ufficiale
Digitally Signed=Firmato digitalmente
This container is digitally signed=Questo Contenitore è firmato digitalmente
Docker Hub=DockerHub
NOTE You must visit the dockerHub page to gather the information required to install correctly=NOTA: È necessario visitare la pagina di DockerHub per ricevere le informazioni necessarie per l’installazione corretta.
Show CA templates=Mostra i template di Community Applications
Deprecated=Obsolete
Incompatible=Incompatibili
Blacklisted=Nella blacklist
Template Exists=Template già presente
Template already exists in Apps=Il template esiste già nelle App
; eg: LinuxServer Repository
%s Repository=%s Repository
; eg: Squid’s Repository
%s’s Repository=Repository di %s

Info=Info
Attention=Attenzione
Repository=Repository
Why we picked it=Perché l’abbiamo scelta
Application Spotlight %s=App in evidenza %s
Unraid Staff=Staff di Unraid

; Page Navigation
Displaying %s - %s of %s=Mostro %1$s - %2$s (di %3$s)
Updating Content=Aggiorno contenuto…
Language=Lingua
Switch to this language=Passa a questa lingua
Country Code=Codice Nazione
Install Language Pack=Installa Pacchetto lingua
Remove Language Pack=Rimuovi Pacchetto lingua
Update Language Pack=Aggiorna Pacchetto lingua
Installed Version=Versione installata
A note about translations=Nota sulle traduzioni
Click here to view the language changelog=Clicca qui per vedere il Changelog
View Missing Translations=Vedi Traduzioni mancanti

; Update Checks
Check For Updates=Verifica aggiornamenti
Check for updates already running=Verifica degli aggiornamenti già in corso…
Checking for docker container updates=Verifica degli aggiornamenti dei Contenitori Docker
Checking for plugin updates=Verifica degli aggiornamenti dei Plugin
Checking for language updates=Verifica degli aggiornamenti dei Pacchetti Lingua
Checking %s=Verifico %s…

; dockerHub conversions
Determine configuration=Determina configurazione
Would you like CA to attempt to determine any applicable paths, ports, and variables for the template This will entail performing a test installation of the container It will be automatically deleted after processing The container will not be started=Vuoi che Community Applications tenti di determinare per il template eventuali percorsi, porte e variabili applicabili? Questo comporterà l’esecuzione di un’installazione di prova del container. Verrà automaticamente eliminato dopo l’elaborazione. Il container non verrà avviato.
An error occurred - Could not determine configuration=Si è verificato un errore - Impossibile determinare la configurazione.

; WebGui
Click Install to download and install the Community Applications plugin=Clicca **Installa** per scaricare e installare il plugin **Community Applications**
Community Applications contains both docker containers and plugin applications Plugins are designed for OS enhancements, and run with full privileges on your system and are clearly identified within CA=Community Applications contiene sia Contenitori Docker che Applicazioni (Plugin). I plugin sono progettati per miglioramenti del sistema operativo e vengono eseguiti con privilegi completi sul tuo sistema. NOTA: sono chiaramente identificati all’interno di Community Applications.
